zip_code;week_ending_date;total_properties_this_week;total_properties_last_week;total_properties_week_change;pct_state_traffic_week_avg;pct_national_traffic_week_avg
01001;2015/09/05 00:00:00.000;39;26;13;0.3058429297;0.0086854103
01001;2015/07/04 00:00:00.000;46;44;2;0.2321072969;0.0068877477
01002;2015/09/05 00:00:00.000;288;134;154;0.3390867264;0.0096294766
01002;2015/07/04 00:00:00.000;212;210;2;0.3296978649;0.0097837325
01005;2015/07/04 00:00:00.000;19;19;0;0.0646207815;0.0019176116
01005;2015/09/05 00:00:00.000;27;15;12;0.090423127;0.0025678604
01007;2015/07/04 00:00:00.000;63;61;2;0.4272884329;0.0126797174
01007;2015/09/05 00:00:00.000;67;39;28;0.1741974947;0.0049469076
01008;2015/07/04 00:00:00.000;6;7;-1;0.0237382463;0.0007044287
01008;2015/09/05 00:00:00.000;10;3;7;0.0252652855;0.0007174904
01010;2015/07/04 00:00:00.000;17;18;-1;0.0527516584;0.0015653972
01010;2015/09/05 00:00:00.000;21;13;8;0.0638280897;0.0018126074
01011;2015/09/05 00:00:00.000;9;7;2;0.0186165262;0.0005286771
01011;2015/07/04 00:00:00.000;7;8;-1;0.0435201182;0.0012914527
01012;2015/07/04 00:00:00.000;4;4;0;0.017144289;0.0005087541
01012;2015/09/05 00:00:00.000;3;2;1;0.019946278;0.0005664398
01013;2015/07/04 00:00:00.000;34;29;5;0.2215569652;0.0065746683
01013;2015/09/05 00:00:00.000;26;17;9;0.131645435;0.0037385027
01020;2015/09/05 00:00:00.000;55;43;12;0.2566421106;0.0072881921
01020;2015/07/04 00:00:00.000;69;64;5;0.3151911588;0.0093532483
01022;2015/07/04 00:00:00.000;19;19;0;0.0553892413;0.0016436671
01022;2015/09/05 00:00:00.000;17;13;4;0.0279247892;0.0007930157
01026;2015/07/04 00:00:00.000;4;4;0;0.0303322036;0.0009001034
01026;2015/09/05 00:00:00.000;7;3;4;0.0079785112;0.0002265759
01027;2015/07/04 00:00:00.000;72;58;14;0.2030938848;0.0060267793
01027;2015/09/05 00:00:00.000;76;40;36;0.1994627802;0.005664398
01028;2015/07/04 00:00:00.000;57;58;-1;0.2096878421;0.0062224539
01030;2015/09/05 00:00:00.000;23;15;8;0.090423127;0.0025678604
01030;2015/07/04 00:00:00.000;17;17;0;0.1160536484;0.0034438739
01031;2015/07/04 00:00:00.000;1;1;0;0.0013187915;0.0000391349
01031;2015/09/05 00:00:00.000;1;1;0;0.0012875315;0.000036346
01032;2015/09/05 00:00:00.000;2;2;0;0.0172867743;0.0004909145
01033;2015/07/04 00:00:00.000;27;25;2;0.097590568;0.0028959848
01033;2015/09/05 00:00:00.000;27;18;9;0.0877636233;0.0024923351
01034;2015/09/05 00:00:00.000;42;22;20;0.0678173453;0.0019258953
01034;2015/07/04 00:00:00.000;36;32;4;0.0290134121;0.0008609685
01036;2015/09/05 00:00:00.000;18;15;3;0.0558495785;0.0015860314
01036;2015/07/04 00:00:00.000;18;15;3;0.0369261609;0.001095778
01037;2015/07/04 00:00:00.000;1;1;0;0.0052751658;0.0001565397
01038;2015/07/04 00:00:00.000;10;7;3;0.0092315402;0.0002739445
01039;2015/07/04 00:00:00.000;5;5;0;0.0026375829;0.0000782699
01039;2015/09/05 00:00:00.000;1;1;0;0.0039892556;0.000113288
01040;2015/07/04 00:00:00.000;45;44;1;0.3455233624;0.0102533517
01040;2015/09/05 00:00:00.000;57;32;25;0.3284487115;0.0093273754
01050;2015/09/05 00:00:00.000;18;9;9;0.0385628042;0.0010951169
01050;2015/07/04 00:00:00.000;11;11;0;0.0844026534;0.0025046355
01053;2015/07/04 00:00:00.000;5;8;-3;0.0065939573;0.0001956747
01053;2015/09/05 00:00:00.000;3;2;1;0.0079785112;0.0002265759
01054;2015/07/04 00:00:00.000;10;12;-2;0.0435201182;0.0012914527
01056;2015/09/05 00:00:00.000;46;28;18;0.1941437728;0.0055133474
01056;2015/07/04 00:00:00.000;44;47;-3;0.195181136;0.0057919697
01057;2015/09/05 00:00:00.000;27;18;9;0.0864338714;0.0024545725
01057;2015/07/04 00:00:00.000;38;36;2;0.1503422264;0.004461382
01060;2015/09/05 00:00:00.000;58;38;20;0.464083402;0.013179166
01062;2015/09/05 00:00:00.000;37;23;14;0.1555809686;0.0044182304
01062;2015/07/04 00:00:00.000;40;34;6;0.2083690506;0.006183319
01068;2015/07/04 00:00:00.000;5;8;-3;0.0197818719;0.000587024
01069;2015/07/04 00:00:00.000;32;33;-1;0.0962717765;0.0028568499
01069;2015/09/05 00:00:00.000;52;34;18;0.1329751868;0.0037762653
01070;2015/07/04 00:00:00.000;1;2;-1;0.0013187915;0.0000391349
01070;2015/09/05 00:00:00.000;5;2;3;0.0132975187;0.0003776265
01071;2015/07/04 00:00:00.000;10;10;0;0.0263758292;0.0007826986
01072;2015/09/05 00:00:00.000;17;10;7;0.0638280897;0.0018126074
01073;2015/09/05 00:00:00.000;30;14;16;0.1276561794;0.0036252147
01075;2015/07/04 00:00:00.000;51;53;-2;0.2228757567;0.0066138032
01077;2015/07/04 00:00:00.000;37;35;2;0.163530141;0.0048527313
01077;2015/09/05 00:00:00.000;29;23;6;0.1848355097;0.0052490088
01080;2015/07/04 00:00:00.000;4;3;1;0.0013187915;0.0000391349
01081;2015/09/05 00:00:00.000;13;7;6;0.030584293;0.000868541
01081;2015/07/04 00:00:00.000;9;11;-2;0.017144289;0.0005087541
01082;2015/09/05 00:00:00.000;67;39;28;0.1555809686;0.0044182304
01082;2015/07/04 00:00:00.000;57;62;-5;0.1173724399;0.0034830088
01084;2015/09/05 00:00:00.000;1;1;0;0.0013297519;0.0000377627
01085;2015/07/04 00:00:00.000;96;104;-8;0.5657615361;0.0167888851
01085;2015/09/05 00:00:00.000;113;79;34;0.5917395814;0.0168043808
01088;2015/09/05 00:00:00.000;3;2;1;0.0013297519;0.0000377627
01088;2015/07/04 00:00:00.000;3;3;0;0.0131879146;0.0003913493
01089;2015/07/04 00:00:00.000;50;47;3;0.2373824627;0.0070442874
01095;2015/09/05 00:00:00.000;46;27;19;0.2446743438;0.0069483282
01095;2015/07/04 00:00:00.000;59;58;1;0.3231039076;0.0095880579
01096;2015/09/05 00:00:00.000;12;4;8;0.0292545411;0.0008307784
01098;2015/07/04 00:00:00.000;13;10;3;0.0184630804;0.000547889
01098;2015/09/05 00:00:00.000;13;6;7;0.0731363528;0.0020769459
01103;2015/09/05 00:00:00.000;3;2;1;0.0079785112;0.0002265759
01103;2015/07/04 00:00:00.000;3;3;0;0.0065939573;0.0001956747
01104;2015/07/04 00:00:00.000;40;38;2;0.0857214449;0.0025437705
01104;2015/09/05 00:00:00.000;48;38;10;0.1675487354;0.0047580943
01105;2015/09/05 00:00:00.000;6;4;2;0.039892556;0.0011328796
01106;2015/09/05 00:00:00.000;62;48;14;0.2832371479;0.0080434452
01107;2015/07/04 00:00:00.000;10;10;0;0.0369261609;0.001095778
01108;2015/09/05 00:00:00.000;51;41;10;0.2366958326;0.0067217523
01108;2015/07/04 00:00:00.000;41;41;0;0.2176005908;0.0064572635
01109;2015/09/05 00:00:00.000;46;29;17;0.1276561794;0.0036252147
01109;2015/07/04 00:00:00.000;34;31;3;0.1819932214;0.0054006204
01118;2015/07/04 00:00:00.000;60;51;9;0.3455233624;0.0102533517
01119;2015/09/05 00:00:00.000;22;18;4;0.0984016383;0.0027944364
01119;2015/07/04 00:00:00.000;30;28;2;0.1094596911;0.0032481992
01128;2015/09/05 00:00:00.000;5;3;2;0.0279247892;0.0007930157
01128;2015/07/04 00:00:00.000;7;6;1;0.0553892413;0.0016436671
01129;2015/07/04 00:00:00.000;20;23;-3;0.0580268242;0.0017219369
01201;2015/09/05 00:00:00.000;85;86;-1;0.4361586128;0.0123861503
01201;2015/07/04 00:00:00.000;99;97;2;0.407506561;0.0120926934
01220;2015/09/05 00:00:00.000;15;15;0;0.1422834499;0.0040406039
01220;2015/07/04 00:00:00.000;8;7;1;0.0619831986;0.0018393417
01223;2015/07/04 00:00:00.000;60;56;4;0.097590568;0.0028959848
01225;2015/09/05 00:00:00.000;5;7;-2;0.0265950374;0.0007552531
01225;2015/07/04 00:00:00.000;6;6;0;0.0250570377;0.0007435637
01226;2015/07/04 00:00:00.000;12;10;2;0.0303322036;0.0009001034
01235;2015/09/05 00:00:00.000;62;52;10;0.039892556;0.0011328796
01235;2015/07/04 00:00:00.000;26;32;-6;0.0329697865;0.0009783733
01236;2015/07/04 00:00:00.000;1;1;0;0.0040524659;0.0001166804
01237;2015/07/04 00:00:00.000;5;5;0;0.0553892413;0.0016436671
01238;2015/09/05 00:00:00.000;23;16;7;0.1077099013;0.0030587749
01238;2015/07/04 00:00:00.000;25;26;-1;0.1569361837;0.0046570567
01240;2015/07/04 00:00:00.000;30;26;4;0.1964999275;0.0058311046
01240;2015/09/05 00:00:00.000;36;35;1;0.2127602989;0.0060420245
01245;2015/07/04 00:00:00.000;6;8;-2;0.0461577011;0.0013697226
01247;2015/07/04 00:00:00.000;84;90;-6;0.1938623445;0.0057528347
01247;2015/09/05 00:00:00.000;128;152;-24;0.2593016143;0.0073637174
01253;2015/07/04 00:00:00.000;16;15;1;0.0567080328;0.001682802
01254;2015/09/05 00:00:00.000;9;4;5;0.0319140448;0.0009063037
01254;2015/07/04 00:00:00.000;10;11;-1;0.031650995;0.0009392383
01255;2015/07/04 00:00:00.000;6;6;0;0.0158254975;0.0004696192
01255;2015/09/05 00:00:00.000;10;7;3;0.0039892556;0.000113288
01257;2015/09/05 00:00:00.000;10;8;2;0.039892556;0.0011328796
01258;2015/09/05 00:00:00.000;8;6;2;0.019946278;0.0005664398
01258;2015/07/04 00:00:00.000;10;14;-4;0.0197818719;0.000587024
01259;2015/07/04 00:00:00.000;3;4;-1;0.0052751658;0.0001565397
01262;2015/07/04 00:00:00.000;7;5;2;0.0844026534;0.0025046355
01262;2015/09/05 00:00:00.000;2;2;0;0.1130289088;0.0032098255
01264;2015/09/05 00:00:00.000;1;1;0;0.0026595037;0.0000755253
01266;2015/09/05 00:00:00.000;5;5;0;0.0518603229;0.0014727435
01266;2015/07/04 00:00:00.000;4;7;-3;0.0369261609;0.001095778
01267;2015/07/04 00:00:00.000;21;24;-3;0.163530141;0.0048527313
01270;2015/07/04 00:00:00.000;5;6;-1;0.0118691231;0.0003522144
01301;2015/07/04 00:00:00.000;49;44;5;0.309915993;0.0091967086
01301;2015/09/05 00:00:00.000;158;84;74;0.2167495545;0.0061553125
01330;2015/07/04 00:00:00.000;3;3;0;0.0105503317;0.0003130794
01330;2015/09/05 00:00:00.000;5;4;1;0.0465413154;0.0013216929
01331;2015/07/04 00:00:00.000;110;120;-10;0.2162817994;0.0064181286
01331;2015/09/05 00:00:00.000;206;98;108;0.1582404723;0.0044937558
01337;2015/07/04 00:00:00.000;12;9;3;0.0356073694;0.0010566431
01339;2015/09/05 00:00:00.000;16;16;0;0.0279247892;0.0007930157
01340;2015/07/04 00:00:00.000;5;6;-1;0.0092315402;0.0002739445
01340;2015/09/05 00:00:00.000;15;10;5;0.0571793303;0.0016237941
01341;2015/07/04 00:00:00.000;9;6;3;0.0501140755;0.0014871273
01342;2015/07/04 00:00:00.000;2;1;1;0.0290134121;0.0008609685
01344;2015/09/05 00:00:00.000;4;3;1;0.0132975187;0.0003776265
01346;2015/09/05 00:00:00.000;5;3;2;0.0132975187;0.0003776265
01346;2015/07/04 00:00:00.000;2;1;1;0.0065939573;0.0001956747
01349;2015/09/05 00:00:00.000;1;1;0;0.0053190075;0.0001510506
01350;2015/09/05 00:00:00.000;1;1;0;0.0066487593;0.0001888133
01354;2015/09/05 00:00:00.000;3;2;1;0.0212760299;0.0006042025
01354;2015/07/04 00:00:00.000;1;2;-1;0.0065939573;0.0001956747
01355;2015/09/05 00:00:00.000;5;3;2;0.0146272706;0.0004153892
01355;2015/07/04 00:00:00.000;5;7;-2;0.0052751658;0.0001565397
01364;2015/07/04 00:00:00.000;19;20;-1;0.0593456157;0.0017610719
01364;2015/09/05 00:00:00.000;24;14;10;0.081114864;0.0023035219
01366;2015/09/05 00:00:00.000;9;7;2;0.0492008191;0.0013972182
01366;2015/07/04 00:00:00.000;5;6;-1;0.0145067061;0.0004304842
01367;2015/07/04 00:00:00.000;1;1;0;0.0079127488;0.0002348096
01368;2015/07/04 00:00:00.000;4;5;-1;0.0158254975;0.0004696192
01370;2015/09/05 00:00:00.000;14;8;6;0.0465413154;0.0013216929
01370;2015/07/04 00:00:00.000;6;5;1;0.0514328669;0.0015262623
01375;2015/07/04 00:00:00.000;7;7;0;0.0382449523;0.001134913
01376;2015/07/04 00:00:00.000;5;5;0;0.0382449523;0.001134913
01376;2015/09/05 00:00:00.000;14;6;8;0.0492008191;0.0013972182
01378;2015/09/05 00:00:00.000;6;4;2;0.0093082631;0.0002643386
01379;2015/07/04 00:00:00.000;1;1;0;0.0118691231;0.0003522144
01420;2015/07/04 00:00:00.000;102;97;5;0.3824495233;0.0113491298
01420;2015/09/05 00:00:00.000;112;77;35;0.424190846;0.0120462864
01430;2015/07/04 00:00:00.000;45;39;6;0.0936341936;0.00277858
01432;2015/09/05 00:00:00.000;24;18;6;0.0797851121;0.0022657592
01434;2015/07/04 00:00:00.000;10;14;-4;0.0026375829;0.0000782699
01436;2015/07/04 00:00:00.000;2;2;0;0.0131879146;0.0003913493
01440;2015/09/05 00:00:00.000;62;41;21;0.2353660807;0.0066839897
01450;2015/07/04 00:00:00.000;48;51;-3;0.2057314677;0.0061050491
01450;2015/09/05 00:00:00.000;39;29;10;0.1635594798;0.0046448064
01451;2015/07/04 00:00:00.000;32;31;1;0.0712147388;0.0021132862
01451;2015/09/05 00:00:00.000;38;27;11;0.1529214649;0.0043427051
01452;2015/07/04 00:00:00.000;14;14;0;0.0382449523;0.001134913
01460;2015/09/05 00:00:00.000;18;18;0;0.1369644424;0.0038895533
01460;2015/07/04 00:00:00.000;22;19;3;0.1938623445;0.0057528347
01462;2015/07/04 00:00:00.000;52;50;2;0.163530141;0.0048527313
01462;2015/09/05 00:00:00.000;43;31;12;0.1981330284;0.0056266354
01468;2015/07/04 00:00:00.000;18;15;3;0.0619831986;0.0018393417
01468;2015/09/05 00:00:00.000;13;9;4;0.0718066009;0.0020391833
01473;2015/07/04 00:00:00.000;20;19;1;0.1055033168;0.0031307944
01475;2015/09/05 00:00:00.000;41;25;16;0.0571793303;0.0016237941
01501;2015/07/04 00:00:00.000;46;47;-1;0.1714428897;0.0050875409
01504;2015/09/05 00:00:00.000;29;21;8;0.0917528789;0.0026056231
01505;2015/09/05 00:00:00.000;13;10;3;0.0664875934;0.0018881327
01506;2015/07/04 00:00:00.000;9;9;0;0.0329697865;0.0009783733
01507;2015/07/04 00:00:00.000;32;34;-2;0.1055033168;0.0031307944
01515;2015/09/05 00:00:00.000;8;7;1;0.0319140448;0.0009063037
01515;2015/07/04 00:00:00.000;10;10;0;0.0250570377;0.0007435637
01516;2015/09/05 00:00:00.000;38;23;15;0.1183479163;0.0033608762
01516;2015/07/04 00:00:00.000;33;31;2;0.1055033168;0.0031307944
01518;2015/07/04 00:00:00.000;13;14;-1;0.0342885779;0.0010175082
01519;2015/09/05 00:00:00.000;19;13;6;0.1502619611;0.0042671798
01520;2015/09/05 00:00:00.000;58;35;23;0.2912156592;0.0082700211
01522;2015/07/04 00:00:00.000;7;6;1;0.031650995;0.0009392383
01522;2015/09/05 00:00:00.000;12;6;6;0.0079785112;0.0002265759
01523;2015/09/05 00:00:00.000;20;11;9;0.1170181644;0.0033231135
01523;2015/07/04 00:00:00.000;22;26;-4;0.1002281509;0.0029742547
01527;2015/07/04 00:00:00.000;30;32;-2;0.1384731032;0.0041091677
01527;2015/09/05 00:00:00.000;37;24;13;0.202122284;0.0057399233
01529;2015/09/05 00:00:00.000;15;11;4;0.0332437967;0.0009440663
01534;2015/07/04 00:00:00.000;21;22;-1;0.1068221082;0.0031699293
01535;2015/07/04 00:00:00.000;19;15;4;0.0778086961;0.0023089609
01535;2015/09/05 00:00:00.000;17;13;4;0.030584293;0.000868541
01536;2015/09/05 00:00:00.000;21;11;10;0.070476849;0.0020014206
01540;2015/09/05 00:00:00.000;40;27;13;0.1662189835;0.0047203317
01542;2015/09/05 00:00:00.000;6;4;2;0.0053190075;0.0001510506
01543;2015/09/05 00:00:00.000;33;20;13;0.1090396532;0.0030965376
01545;2015/07/04 00:00:00.000;77;72;5;0.5407044984;0.0160453214
01550;2015/09/05 00:00:00.000;37;25;12;0.1116991569;0.0031720629
01560;2015/09/05 00:00:00.000;12;5;7;0.0412223079;0.0011706423
01562;2015/07/04 00:00:00.000;40;39;1;0.129241563;0.0038352232
01562;2015/09/05 00:00:00.000;45;34;11;0.1223371719;0.0034741641
01564;2015/09/05 00:00:00.000;23;16;7;0.0930826308;0.0026433857
01568;2015/09/05 00:00:00.000;24;15;9;0.1542512167;0.0043804678
01569;2015/07/04 00:00:00.000;46;50;-4;0.1305603545;0.0038743581
01569;2015/09/05 00:00:00.000;42;33;9;0.1888247653;0.0053622968
01570;2015/07/04 00:00:00.000;52;53;-1;0.1173724399;0.0034830088
01571;2015/09/05 00:00:00.000;41;32;9;0.0984016383;0.0027944364
01583;2015/07/04 00:00:00.000;12;13;-1;0.0791274876;0.0023480958
01583;2015/09/05 00:00:00.000;21;16;5;0.1436132018;0.0040783666
01585;2015/09/05 00:00:00.000;21;13;8;0.081114864;0.0023035219
01588;2015/07/04 00:00:00.000;29;29;0;0.0593456157;0.0017610719
01588;2015/09/05 00:00:00.000;34;24;10;0.1369644424;0.0038895533
01590;2015/07/04 00:00:00.000;25;29;-4;0.1266039801;0.0037569533
01602;2015/09/05 00:00:00.000;76;54;22;0.4108933273;0.0116686599
01603;2015/09/05 00:00:00.000;35;21;14;0.1569107205;0.0044559931
01604;2015/07/04 00:00:00.000;70;63;7;0.4193756841;0.0124449078
01605;2015/07/04 00:00:00.000;27;27;0;0.1753992641;0.0052049457
01606;2015/09/05 00:00:00.000;56;40;16;0.413552831;0.0117441852
01606;2015/07/04 00:00:00.000;50;48;2;0.2874965382;0.0085314148
01607;2015/09/05 00:00:00.000;16;12;4;0.050530571;0.0014349808
01608;2015/07/04 00:00:00.000;1;1;0;0.0197818719;0.000587024
01609;2015/07/04 00:00:00.000;50;54;-4;0.3639864428;0.0108012407
01610;2015/09/05 00:00:00.000;9;7;2;0.0970718864;0.0027566737
01611;2015/09/05 00:00:00.000;12;8;4;0.0106380149;0.0003021012
01612;2015/07/04 00:00:00.000;15;15;0;0.0725335303;0.0021524212
01702;2015/09/05 00:00:00.000;38;28;10;0.3550437488;0.0100826285
01718;2015/07/04 00:00:00.000;1;2;-1;0.0079127488;0.0002348096
01720;2015/07/04 00:00:00.000;59;58;1;0.3468421539;0.0102924866
01721;2015/09/05 00:00:00.000;23;22;1;0.2659503737;0.0075525307
01721;2015/07/04 00:00:00.000;30;34;-4;0.261120709;0.0077487162
01730;2015/09/05 00:00:00.000;24;17;7;0.1436132018;0.0040783666
01740;2015/07/04 00:00:00.000;35;35;0;0.1213288143;0.0036004136
01741;2015/09/05 00:00:00.000;20;19;1;0.0797851121;0.0022657592
01742;2015/09/05 00:00:00.000;74;55;19;0.2619611181;0.0074392427
01746;2015/07/04 00:00:00.000;32;34;-2;0.2307885054;0.0068486128
01746;2015/09/05 00:00:00.000;37;19;18;0.2087710433;0.0059287366
01747;2015/09/05 00:00:00.000;9;9;0;0.0518603229;0.0014727435
01747;2015/07/04 00:00:00.000;11;12;-1;0.0712147388;0.0021132862
01749;2015/09/05 00:00:00.000;31;20;11;0.2593016143;0.0073637174
01752;2015/09/05 00:00:00.000;72;55;17;0.4733916651;0.0134435046
01752;2015/07/04 00:00:00.000;67;71;-4;0.4127817268;0.0122492332
01754;2015/07/04 00:00:00.000;31;29;2;0.1358355203;0.0040308978
01756;2015/09/05 00:00:00.000;24;15;9;0.0558495785;0.0015860314
01757;2015/09/05 00:00:00.000;39;25;14;0.2539826068;0.0072126668
01760;2015/07/04 00:00:00.000;63;63;0;0.7187413454;0.021328537
01770;2015/07/04 00:00:00.000;44;39;5;0.097590568;0.0028959848
01772;2015/09/05 00:00:00.000;39;26;13;0.2074412915;0.0058909739
01773;2015/09/05 00:00:00.000;14;14;0;0.1170181644;0.0033231135
01775;2015/07/04 00:00:00.000;23;25;-2;0.1041845253;0.0030916595
01776;2015/07/04 00:00:00.000;58;61;-3;0.2452952115;0.007279097
01776;2015/09/05 00:00:00.000;48;31;17;0.2446743438;0.0069483282
01778;2015/09/05 00:00:00.000;37;28;9;0.2380255844;0.006759515
01801;2015/09/05 00:00:00.000;47;38;9;0.5013164543;0.0142365203
01803;2015/07/04 00:00:00.000;35;33;2;0.3455233624;0.0102533517
01803;2015/09/05 00:00:00.000;34;23;11;0.2991941704;0.008496597
01810;2015/07/04 00:00:00.000;112;98;14;0.5829058251;0.0172976391
01821;2015/07/04 00:00:00.000;50;43;7;0.4470703048;0.0132667413
01821;2015/09/05 00:00:00.000;48;29;19;0.3816387862;0.0108378815
01826;2015/09/05 00:00:00.000;73;53;20;0.3151511928;0.0089497489
01827;2015/09/05 00:00:00.000;9;5;4;0.0465413154;0.0013216929
01830;2015/07/04 00:00:00.000;50;53;-3;0.2532079602;0.0075139066
01832;2015/09/05 00:00:00.000;55;48;7;0.3896172974;0.0110644575
01834;2015/09/05 00:00:00.000;8;9;-1;0.0824446158;0.0023412845
01835;2015/07/04 00:00:00.000;24;30;-6;0.1424294776;0.0042265725
01835;2015/09/05 00:00:00.000;37;24;13;0.2061115396;0.0058532113
01843;2015/09/05 00:00:00.000;17;13;4;0.1781867504;0.0050601956
01843;2015/07/04 00:00:00.000;18;21;-3;0.1424294776;0.0042265725
01844;2015/07/04 00:00:00.000;98;86;12;0.6501641895;0.0192935206
01845;2015/09/05 00:00:00.000;73;56;17;0.2845668998;0.0080812078
01850;2015/07/04 00:00:00.000;29;26;3;0.1120972741;0.0033264691
01850;2015/09/05 00:00:00.000;24;15;9;0.1236669238;0.0035119268
01851;2015/07/04 00:00:00.000;20;19;1;0.2663958748;0.0079052559
01851;2015/09/05 00:00:00.000;29;22;7;0.2007925321;0.0057021607
01852;2015/09/05 00:00:00.000;60;40;20;0.3577032526;0.0101581538
01860;2015/07/04 00:00:00.000;13;10;3;0.0857214449;0.0025437705
01862;2015/09/05 00:00:00.000;16;8;8;0.0864338714;0.0024545725
01862;2015/07/04 00:00:00.000;15;15;0;0.0698959474;0.0020741513
01863;2015/09/05 00:00:00.000;18;17;1;0.0678173453;0.0019258953
01867;2015/07/04 00:00:00.000;33;38;-5;0.2624395004;0.0077878511
01879;2015/07/04 00:00:00.000;26;27;-1;0.1055033168;0.0031307944
01880;2015/07/04 00:00:00.000;42;39;3;0.4958655888;0.0147147338
01887;2015/07/04 00:00:00.000;19;22;-3;0.2835401638;0.00841401
01901;2015/07/04 00:00:00.000;1;1;0;0.0079127488;0.0002348096
01902;2015/07/04 00:00:00.000;41;38;3;0.4259696414;0.0126405825
01906;2015/07/04 00:00:00.000;35;35;0;0.4892716315;0.0145190591
01907;2015/07/04 00:00:00.000;36;35;1;0.3916810635;0.0116230743
01915;2015/07/04 00:00:00.000;63;58;5;0.5420232899;0.0160844563
01921;2015/07/04 00:00:00.000;34;27;7;0.1002281509;0.0029742547
01930;2015/07/04 00:00:00.000;81;73;8;0.7648990465;0.0226982595
01940;2015/07/04 00:00:00.000;26;27;-1;0.2466140029;0.0073182319
01949;2015/07/04 00:00:00.000;26;26;0;0.2096878421;0.0062224539
01950;2015/07/04 00:00:00.000;81;77;4;0.6251071518;0.0185499569
01960;2015/07/04 00:00:00.000;59;62;-3;0.7767681696;0.0230504739
01969;2015/07/04 00:00:00.000;17;15;2;0.1041845253;0.0030916595
01970;2015/07/04 00:00:00.000;94;95;-1;0.8084191647;0.0239897122
01983;2015/07/04 00:00:00.000;12;12;0;0.0778086961;0.0023089609
01984;2015/07/04 00:00:00.000;16;18;-2;0.0751711132;0.002230691
02021;2015/07/04 00:00:00.000;56;47;9;0.4497078877;0.0133450112
02026;2015/07/04 00:00:00.000;42;41;1;0.3521173197;0.0104490264
02038;2015/07/04 00:00:00.000;64;62;2;0.5604863703;0.0166323453
02045;2015/07/04 00:00:00.000;83;80;3;0.375855566;0.0111534551
02050;2015/07/04 00:00:00.000;91;81;10;0.4628958023;0.0137363605
02056;2015/07/04 00:00:00.000;34;34;0;0.212325425;0.0063007238
02066;2015/07/04 00:00:00.000;85;80;5;0.4800400913;0.0142451146
02067;2015/07/04 00:00:00.000;49;48;1;0.2729898321;0.0081009306
02081;2015/07/04 00:00:00.000;48;43;5;0.3521173197;0.0104490264
02090;2015/07/04 00:00:00.000;50;46;4;0.2479327944;0.0073573669
02110;2015/07/04 00:00:00.000;6;11;-5;0.0778086961;0.0023089609
02111;2015/07/04 00:00:00.000;18;18;0;0.0474764925;0.0014088575
02113;2015/07/04 00:00:00.000;6;6;0;0.1094596911;0.0032481992
02114;2015/07/04 00:00:00.000;18;17;1;0.4167381012;0.0123666379
02118;2015/07/04 00:00:00.000;37;43;-6;0.5130098777;0.0152234878
02119;2015/07/04 00:00:00.000;6;7;-1;0.1252851887;0.0037178184
02124;2015/07/04 00:00:00.000;34;50;-16;0.2743086236;0.0081400655
02128;2015/07/04 00:00:00.000;17;16;1;0.3349730307;0.0099402723
02129;2015/07/04 00:00:00.000;39;41;-2;0.358711277;0.010644701
02132;2015/07/04 00:00:00.000;33;36;-3;0.42465085;0.0126014475
02136;2015/07/04 00:00:00.000;30;32;-2;0.275627415;0.0081792004
02141;2015/07/04 00:00:00.000;9;10;-1;0.1688053068;0.0050092711
02152;2015/07/04 00:00:00.000;23;22;1;0.3231039076;0.0095880579
02170;2015/07/04 00:00:00.000;11;13;-2;0.1767180556;0.0052440806
02171;2015/07/04 00:00:00.000;26;26;0;0.2096878421;0.0062224539
02176;2015/07/04 00:00:00.000;25;31;-6;0.4760837169;0.0141277098
02188;2015/07/04 00:00:00.000;20;23;-3;0.2110066335;0.0062615888
02191;2015/07/04 00:00:00.000;17;17;0;0.1516610178;0.004500517
02302;2015/07/04 00:00:00.000;41;45;-4;0.4338823902;0.012875392
02322;2015/07/04 00:00:00.000;14;12;2;0.1081408997;0.0032090643
02330;2015/07/04 00:00:00.000;53;45;8;0.3929998549;0.0116622092
02338;2015/07/04 00:00:00.000;19;16;3;0.0870402363;0.0025829054
02343;2015/07/04 00:00:00.000;18;15;3;0.1964999275;0.0058311046
02367;2015/07/04 00:00:00.000;8;10;-2;0.0474764925;0.0014088575
02368;2015/07/04 00:00:00.000;43;35;8;0.5156474607;0.0153017577
02379;2015/07/04 00:00:00.000;22;20;2;0.1450670605;0.0043048423
02420;2015/07/04 00:00:00.000;38;43;-5;0.3969562293;0.011779614
02421;2015/07/04 00:00:00.000;30;35;-5;0.3020032442;0.008961899
02445;2015/07/04 00:00:00.000;38;44;-6;0.4694897596;0.0139320351
02446;2015/07/04 00:00:00.000;32;32;0;0.4127817268;0.0122492332
02451;2015/07/04 00:00:00.000;22;26;-4;0.1925435531;0.0057136998
02452;2015/07/04 00:00:00.000;17;17;0;0.1371543118;0.0040700327
02461;2015/07/04 00:00:00.000;12;13;-1;0.0830838619;0.0024655006
02462;2015/07/04 00:00:00.000;3;3;0;0.031650995;0.0009392383
02466;2015/07/04 00:00:00.000;8;10;-2;0.0606644071;0.0018002068
02467;2015/07/04 00:00:00.000;44;45;-1;0.2545267517;0.0075530415
02472;2015/07/04 00:00:00.000;32;30;2;0.4510266792;0.0133841461
02474;2015/07/04 00:00:00.000;20;23;-3;0.3679428172;0.0109186455
02476;2015/07/04 00:00:00.000;16;17;-1;0.3085972015;0.0091575737
02482;2015/07/04 00:00:00.000;39;39;0;0.2373824627;0.0070442874
02492;2015/07/04 00:00:00.000;43;50;-7;0.2532079602;0.0075139066
02537;2015/07/04 00:00:00.000;57;53;4;0.2004563018;0.0059485094
02538;2015/07/04 00:00:00.000;21;19;2;0.0435201182;0.0012914527
02540;2015/07/04 00:00:00.000;81;77;4;0.5644427447;0.0167497501
02559;2015/07/04 00:00:00.000;21;21;0;0.1397918947;0.0041483026
02568;2015/07/04 00:00:00.000;20;17;3;0.1160536484;0.0034438739
02571;2015/07/04 00:00:00.000;108;112;-4;0.6066440714;0.0180020679
02576;2015/07/04 00:00:00.000;17;20;-3;0.0619831986;0.0018393417
02601;2015/07/04 00:00:00.000;60;55;5;0.2809025809;0.0083357401
02630;2015/07/04 00:00:00.000;20;22;-2;0.1450670605;0.0043048423
02631;2015/07/04 00:00:00.000;83;79;4;0.4259696414;0.0126405825
02632;2015/07/04 00:00:00.000;49;52;-3;0.2532079602;0.0075139066
02633;2015/07/04 00:00:00.000;64;60;4;0.4615770108;0.0136972256
02635;2015/07/04 00:00:00.000;28;25;3;0.1516610178;0.004500517
02638;2015/07/04 00:00:00.000;30;30;0;0.2954092869;0.0087662244
02639;2015/07/04 00:00:00.000;32;28;4;0.2321072969;0.0068877477
02642;2015/07/04 00:00:00.000;59;63;-4;0.3837683147;0.0113882647
02644;2015/07/04 00:00:00.000;21;18;3;0.0501140755;0.0014871273
02645;2015/07/04 00:00:00.000;58;57;1;0.3020032442;0.008961899
02646;2015/07/04 00:00:00.000;21;17;4;0.1872683872;0.0055571601
02648;2015/07/04 00:00:00.000;29;26;3;0.1437482691;0.0042657074
02649;2015/07/04 00:00:00.000;111;119;-8;0.5116910863;0.0151843529
02650;2015/07/04 00:00:00.000;12;12;0;0.0501140755;0.0014871273
02652;2015/07/04 00:00:00.000;10;9;1;0.0448389096;0.0013305876
02653;2015/07/04 00:00:00.000;55;49;6;0.3112347844;0.0092358435
02655;2015/07/04 00:00:00.000;48;43;5;0.2637582919;0.007826986
02657;2015/07/04 00:00:00.000;62;66;-4;0.3362918222;0.0099794072
02659;2015/07/04 00:00:00.000;7;8;-1;0.0435201182;0.0012914527
02660;2015/07/04 00:00:00.000;31;31;0;0.1964999275;0.0058311046
02664;2015/07/04 00:00:00.000;47;45;2;0.2993656613;0.0088836292
02666;2015/07/04 00:00:00.000;10;9;1;0.2360636713;0.0070051525
02667;2015/07/04 00:00:00.000;36;32;4;0.2413388371;0.0071616922
02668;2015/07/04 00:00:00.000;13;13;0;0.0712147388;0.0021132862
02670;2015/07/04 00:00:00.000;21;24;-3;0.1186912314;0.0035221437
02671;2015/07/04 00:00:00.000;16;19;-3;0.0738523217;0.0021915561
02672;2015/07/04 00:00:00.000;1;1;0;0.0369261609;0.001095778
02673;2015/07/04 00:00:00.000;61;76;-15;0.2017750933;0.0059876443
02675;2015/07/04 00:00:00.000;34;35;-1;0.1477046435;0.0043831122
02702;2015/07/04 00:00:00.000;19;18;1;0.0567080328;0.001682802
02703;2015/07/04 00:00:00.000;73;79;-6;0.6040064885;0.017923798
02715;2015/07/04 00:00:00.000;9;9;0;0.0619831986;0.0018393417
02717;2015/07/04 00:00:00.000;13;16;-3;0.0474764925;0.0014088575
02718;2015/07/04 00:00:00.000;14;15;-1;0.0672583644;0.0019958814
02719;2015/07/04 00:00:00.000;62;58;4;0.3231039076;0.0095880579
02720;2015/07/04 00:00:00.000;41;39;2;0.2255133396;0.0066920731
02721;2015/07/04 00:00:00.000;23;27;-4;0.1107784826;0.0032873341
02723;2015/07/04 00:00:00.000;21;17;4;0.1028657338;0.0030525246
02725;2015/07/04 00:00:00.000;9;7;2;0.0751711132;0.002230691
02726;2015/07/04 00:00:00.000;35;31;4;0.2057314677;0.0061050491
02740;2015/07/04 00:00:00.000;45;47;-2;0.358711277;0.010644701
02745;2015/07/04 00:00:00.000;46;42;4;0.1925435531;0.0057136998
02746;2015/07/04 00:00:00.000;6;7;-1;0.0448389096;0.0013305876
02760;2015/07/04 00:00:00.000;66;65;1;0.4853152571;0.0144016543
02764;2015/07/04 00:00:00.000;8;5;3;0.0342885779;0.0010175082
02766;2015/07/04 00:00:00.000;41;38;3;0.3059596186;0.0090793038
02769;2015/07/04 00:00:00.000;36;34;2;0.1964999275;0.0058311046
02770;2015/07/04 00:00:00.000;17;15;2;0.1120972741;0.0033264691
02780;2015/07/04 00:00:00.000;80;83;-3;0.5090535034;0.0151060831
02802;2015/07/04 00:00:00.000;2;1;1;0.0257864879;0.0001101093
02804;2015/07/04 00:00:00.000;10;10;0;0.1096691647;0.0004696192
02806;2015/07/04 00:00:00.000;92;89;3;2.4858343996;0.010644701
02807;2015/07/04 00:00:00.000;5;5;0;0.6488758911;0.00277858
02808;2015/07/04 00:00:00.000;7;8;-1;0.1188082617;0.0005087541
02809;2015/07/04 00:00:00.000;59;52;7;2.1385487114;0.0091575737
02812;2015/07/04 00:00:00.000;7;7;0;0.1370864559;0.000587024
02813;2015/07/04 00:00:00.000;38;43;-5;1.9831840614;0.0084922799
02814;2015/07/04 00:00:00.000;16;15;1;0.5209285323;0.002230691
02815;2015/07/04 00:00:00.000;1;1;0;0.0091390971;0.0000391349
02818;2015/07/04 00:00:00.000;106;113;-7;2.2116614878;0.0094706531
02822;2015/07/04 00:00:00.000;13;14;-1;0.3564247852;0.0015262623
02825;2015/07/04 00:00:00.000;15;18;-3;0.475233047;0.0020350164
02831;2015/07/04 00:00:00.000;17;16;1;0.2558947176;0.001095778
02832;2015/07/04 00:00:00.000;22;25;-3;0.4295375617;0.0018393417
02837;2015/07/04 00:00:00.000;17;13;4;1.9283494791;0.0082574703
02842;2015/07/04 00:00:00.000;46;46;0;1.3251690733;0.0056745649
02857;2015/07/04 00:00:00.000;30;32;-2;0.9778833851;0.0041874375
02858;2015/07/04 00:00:00.000;1;1;0;0.0091390971;0.0000391349
02861;2015/07/04 00:00:00.000;41;40;1;1.590202888;0.0068094779
02865;2015/07/04 00:00:00.000;40;37;3;2.2664960702;0.0097054627
02871;2015/07/04 00:00:00.000;85;83;2;2.4309998172;0.0104098914
02875;2015/07/04 00:00:00.000;1;1;0;0.0182781941;0.0000782699
02879;2015/07/04 00:00:00.000;85;81;4;2.8057027966;0.0120144236
02885;2015/07/04 00:00:00.000;26;23;3;0.8499360263;0.0036395485
02886;2015/07/04 00:00:00.000;80;87;-7;2.5955035642;0.0111143202
02889;2015/07/04 00:00:00.000;101;96;5;3.2443794553;0.0138929002
02891;2015/07/04 00:00:00.000;82;81;1;2.8331200877;0.0121318284
02893;2015/07/04 00:00:00.000;79;68;11;1.5079510144;0.0064572635
02894;2015/07/04 00:00:00.000;2;3;-1;0.0639736794;0.0002739445
02905;2015/07/04 00:00:00.000;85;84;1;1.7090111497;0.0073182319
02906;2015/07/04 00:00:00.000;82;88;-6;3.8110034729;0.0163192659
02909;2015/07/04 00:00:00.000;50;46;4;1.4531164321;0.0062224539
02910;2015/07/04 00:00:00.000;44;49;-5;1.754706635;0.0075139066
02914;2015/07/04 00:00:00.000;28;30;-2;1.3068908792;0.005596295
02915;2015/07/04 00:00:00.000;45;48;-3;1.7455675379;0.0074747717
02919;2015/07/04 00:00:00.000;63;60;3;2.0928532261;0.008961899
03031;2015/07/04 00:00:00.000;81;90;-9;1.3020651033;0.007279097
03032;2015/07/04 00:00:00.000;23;21;2;0.3500175009;0.0019567465
03033;2015/07/04 00:00:00.000;26;29;-3;0.2800140007;0.0015653972
03034;2015/07/04 00:00:00.000;12;12;0;0.3010150508;0.001682802
03036;2015/07/04 00:00:00.000;25;30;-5;0.413020651;0.0023089609
03037;2015/07/04 00:00:00.000;24;23;1;0.3570178509;0.0019958814
03042;2015/07/04 00:00:00.000;36;36;0;0.413020651;0.0023089609
03044;2015/07/04 00:00:00.000;16;21;-5;0.2380119006;0.0013305876
03045;2015/07/04 00:00:00.000;49;54;-5;1.1410570529;0.0063789936
03047;2015/07/04 00:00:00.000;8;8;0;0.0280014001;0.0001565397
03048;2015/07/04 00:00:00.000;64;64;0;0.0910045502;0.0005087541
03053;2015/07/04 00:00:00.000;96;101;-5;1.7080854043;0.009548923
03054;2015/07/04 00:00:00.000;111;106;5;1.9600980049;0.0109577805
03060;2015/07/04 00:00:00.000;43;42;1;1.6310815541;0.0091184387
03064;2015/07/04 00:00:00.000;40;40;0;0.5880294015;0.0032873341
03070;2015/07/04 00:00:00.000;30;40;-10;0.3290164508;0.0018393417
03076;2015/07/04 00:00:00.000;24;24;0;1.2250612531;0.0068486128
03077;2015/07/04 00:00:00.000;41;41;0;0.5740287014;0.0032090643
03086;2015/07/04 00:00:00.000;19;15;4;0.2450122506;0.0013697226
03087;2015/07/04 00:00:00.000;68;63;5;1.4980749037;0.0083748751
03102;2015/07/04 00:00:00.000;61;64;-3;1.2320616031;0.0068877477
03103;2015/07/04 00:00:00.000;86;83;3;1.4490724536;0.0081009306
03106;2015/07/04 00:00:00.000;48;45;3;0.9030451523;0.005048406
03110;2015/07/04 00:00:00.000;83;88;-5;2.2891144557;0.0127971222
03216;2015/07/04 00:00:00.000;14;15;-1;0.0910045502;0.0005087541
03217;2015/07/04 00:00:00.000;10;13;-3;0.1820091005;0.0010175082
03220;2015/07/04 00:00:00.000;72;88;-16;0.3150157508;0.0017610719
03221;2015/07/04 00:00:00.000;14;10;4;0.1610080504;0.0009001034
03223;2015/07/04 00:00:00.000;31;37;-6;0.4480224011;0.0025046355
03224;2015/07/04 00:00:00.000;19;20;-1;0.2660133007;0.0014871273
03229;2015/07/04 00:00:00.000;34;33;1;0.3780189009;0.0021132862
03230;2015/07/04 00:00:00.000;9;9;0;0.0350017501;0.0001956747
03234;2015/07/04 00:00:00.000;22;20;2;0.0980049002;0.000547889
03235;2015/07/04 00:00:00.000;50;63;-13;0.6370318516;0.0035612786
03241;2015/07/04 00:00:00.000;5;7;-2;0.1260063003;0.0007044287
03242;2015/07/04 00:00:00.000;18;22;-4;0.1260063003;0.0007044287
03245;2015/07/04 00:00:00.000;11;10;1;0.3290164508;0.0018393417
03246;2015/07/04 00:00:00.000;227;262;-35;1.8060903045;0.010096812
03251;2015/07/04 00:00:00.000;24;32;-8;0.2800140007;0.0015653972
03256;2015/07/04 00:00:00.000;23;24;-1;0.1400070004;0.0007826986
03257;2015/07/04 00:00:00.000;32;35;-3;0.406020301;0.002269826
03259;2015/07/04 00:00:00.000;1;1;0;0.0140007;0.0000782699
03264;2015/07/04 00:00:00.000;24;25;-1;0.2450122506;0.0013697226
03275;2015/07/04 00:00:00.000;134;136;-2;0.4970248512;0.00277858
03276;2015/07/04 00:00:00.000;190;256;-66;0.5390269513;0.0030133896
03278;2015/07/04 00:00:00.000;13;16;-3;0.3080154008;0.0017219369
03279;2015/07/04 00:00:00.000;6;6;0;0.0490024501;0.0002739445
03280;2015/07/04 00:00:00.000;30;31;-1;0.0840042002;0.0004696192
03281;2015/07/04 00:00:00.000;46;56;-10;0.5460273014;0.0030525246
03282;2015/07/04 00:00:00.000;4;4;0;0.0490024501;0.0002739445
03284;2015/07/04 00:00:00.000;3;4;-1;0.0980049002;0.000547889
03285;2015/07/04 00:00:00.000;40;42;-2;0.3220161008;0.0018002068
03287;2015/07/04 00:00:00.000;7;6;1;0.0700035002;0.0003913493
03290;2015/07/04 00:00:00.000;24;26;-2;0.3640182009;0.0020350164
03301;2015/07/04 00:00:00.000;100;104;-4;1.8620931047;0.0104098914
03303;2015/07/04 00:00:00.000;567;627;-60;1.204060203;0.006731208
03304;2015/07/04 00:00:00.000;48;57;-9;0.4340217011;0.0024263657
03307;2015/07/04 00:00:00.000;30;36;-6;0.2940147007;0.0016436671
03431;2015/07/04 00:00:00.000;141;169;-28;1.0430521526;0.0058311046
03440;2015/07/04 00:00:00.000;21;25;-4;0.1260063003;0.0007044287
03442;2015/07/04 00:00:00.000;6;10;-4;0.0560028001;0.0003130794
03443;2015/07/04 00:00:00.000;4;4;0;0.0420021001;0.0002348096
03444;2015/07/04 00:00:00.000;9;8;1;0.1190059503;0.0006652938
03445;2015/07/04 00:00:00.000;7;5;2;0.0840042002;0.0004696192
03446;2015/07/04 00:00:00.000;29;36;-7;0.0910045502;0.0005087541
03447;2015/07/04 00:00:00.000;16;22;-6;0.1470073504;0.0008218335
03448;2015/07/04 00:00:00.000;8;8;0;0.0560028001;0.0003130794
03449;2015/07/04 00:00:00.000;17;18;-1;0.2170108505;0.0012131828
03450;2015/07/04 00:00:00.000;7;7;0;0.0350017501;0.0001956747
03451;2015/07/04 00:00:00.000;10;14;-4;0.1400070004;0.0007826986
03452;2015/07/04 00:00:00.000;21;24;-3;0.1190059503;0.0006652938
03455;2015/07/04 00:00:00.000;9;10;-1;0.0700035002;0.0003913493
03456;2015/07/04 00:00:00.000;5;4;1;0.0350017501;0.0001956747
03457;2015/07/04 00:00:00.000;8;9;-1;0.0350017501;0.0001956747
03458;2015/07/04 00:00:00.000;42;48;-6;0.5390269513;0.0030133896
03461;2015/07/04 00:00:00.000;23;26;-3;0.3640182009;0.0020350164
03462;2015/07/04 00:00:00.000;16;22;-6;0.1120056003;0.0006261589
03464;2015/07/04 00:00:00.000;18;18;0;0.0490024501;0.0002739445
03465;2015/07/04 00:00:00.000;6;6;0;0.0490024501;0.0002739445
03466;2015/07/04 00:00:00.000;12;15;-3;0.0140007;0.0000782699
03467;2015/07/04 00:00:00.000;14;14;0;0.1120056003;0.0006261589
03470;2015/07/04 00:00:00.000;88;116;-28;0.3150157508;0.0017610719
03561;2015/07/04 00:00:00.000;15;20;-5;0.5950297515;0.0033264691
03570;2015/07/04 00:00:00.000;37;32;5;0.3010150508;0.001682802
03574;2015/07/04 00:00:00.000;15;21;-6;0.399019951;0.002230691
03576;2015/07/04 00:00:00.000;44;44;0;0.2730136507;0.0015262623
03582;2015/07/04 00:00:00.000;34;36;-2;0.0420021001;0.0002348096
03583;2015/07/04 00:00:00.000;3;4;-1;0.0420021001;0.0002348096
03586;2015/07/04 00:00:00.000;4;4;0;0.0770038502;0.0004304842
03593;2015/07/04 00:00:00.000;1;1;0;0.0490024501;0.0002739445
03602;2015/07/04 00:00:00.000;44;60;-16;0.0840042002;0.0004696192
03741;2015/07/04 00:00:00.000;28;28;0;0.0980049002;0.000547889
03743;2015/07/04 00:00:00.000;50;51;-1;0.6160308015;0.0034438739
03748;2015/07/04 00:00:00.000;22;26;-4;0.392019601;0.0021915561
03752;2015/07/04 00:00:00.000;3;4;-1;0.0210010501;0.0001174048
03753;2015/07/04 00:00:00.000;40;52;-12;0.4340217011;0.0024263657
03765;2015/07/04 00:00:00.000;2;2;0;0.1050052503;0.000587024
03766;2015/07/04 00:00:00.000;22;23;-1;0.5880294015;0.0032873341
03777;2015/07/04 00:00:00.000;5;6;-1;0.0140007;0.0000782699
03779;2015/07/04 00:00:00.000;1;1;0;0.0140007;0.0000782699
03781;2015/07/04 00:00:00.000;5;6;-1;0.1120056003;0.0006261589
03782;2015/07/04 00:00:00.000;30;27;3;0.5670283514;0.0031699293
03809;2015/07/04 00:00:00.000;38;44;-6;0.5180259013;0.0028959848
03810;2015/07/04 00:00:00.000;22;22;0;0.1750087504;0.0009783733
03813;2015/07/04 00:00:00.000;42;64;-22;0.2240112006;0.0012523178
03814;2015/07/04 00:00:00.000;18;14;4;0.0910045502;0.0005087541
03819;2015/07/04 00:00:00.000;27;27;0;0.2170108505;0.0012131828
03820;2015/07/04 00:00:00.000;110;133;-23;2.5271263563;0.0141277098
03823;2015/07/04 00:00:00.000;12;10;2;0.2170108505;0.0012131828
03824;2015/07/04 00:00:00.000;44;49;-5;0.4690234512;0.0026220403
03833;2015/07/04 00:00:00.000;480;426;54;2.0581029051;0.0115056695
03837;2015/07/04 00:00:00.000;34;28;6;0.0420021001;0.0002348096
03841;2015/07/04 00:00:00.000;33;36;-3;0.6790339517;0.0037960882
03842;2015/07/04 00:00:00.000;128;128;0;2.8491424571;0.0159279166
03846;2015/07/04 00:00:00.000;5;7;-2;0.0980049002;0.000547889
03851;2015/07/04 00:00:00.000;28;25;3;0.6300315016;0.0035221437
03852;2015/07/04 00:00:00.000;1;2;-1;0.0140007;0.0000782699
03855;2015/07/04 00:00:00.000;24;28;-4;0.2590129506;0.0014479924
03856;2015/07/04 00:00:00.000;8;9;-1;0.1050052503;0.000587024
03860;2015/07/04 00:00:00.000;22;30;-8;0.7210360518;0.0040308978
03861;2015/07/04 00:00:00.000;22;23;-1;0.2170108505;0.0012131828
03867;2015/07/04 00:00:00.000;74;82;-8;1.3650682534;0.0076313114
03870;2015/07/04 00:00:00.000;31;32;-1;0.8890444522;0.0049701361
03871;2015/07/04 00:00:00.000;4;4;0;0.0560028001;0.0003130794
03875;2015/07/04 00:00:00.000;1;1;0;0.0770038502;0.0004304842
03878;2015/07/04 00:00:00.000;35;34;1;0.4270213511;0.0023872307
03886;2015/07/04 00:00:00.000;18;21;-3;0.3780189009;0.0021132862
03887;2015/07/04 00:00:00.000;15;15;0;0.1050052503;0.000587024
03901;2015/07/04 00:00:00.000;20;23;-3;0.3422348976;0.0025829054
03902;2015/07/04 00:00:00.000;14;13;1;0.1918589577;0.0014479924
03903;2015/07/04 00:00:00.000;30;28;2;0.3526056521;0.0026611753
03904;2015/07/04 00:00:00.000;32;35;-3;0.8504018667;0.0064181286
03905;2015/07/04 00:00:00.000;11;9;2;0.285195748;0.0021524212
03906;2015/07/04 00:00:00.000;18;18;0;0.1659320716;0.0012523178
03907;2015/07/04 00:00:00.000;28;28;0;1.2133782733;0.0091575737
03908;2015/07/04 00:00:00.000;19;22;-3;0.570391496;0.0043048423
03911;2015/07/04 00:00:00.000;2;1;1;0.0051853772;0.0000391349
04001;2015/07/04 00:00:00.000;18;17;1;0.2903811252;0.0021915561
04005;2015/07/04 00:00:00.000;74;79;-5;1.4156079855;0.0106838359
04006;2015/07/04 00:00:00.000;1;1;0;0.0259268862;0.0001956747
04008;2015/07/04 00:00:00.000;11;13;-2;0.3992740472;0.0030133896
04010;2015/07/04 00:00:00.000;4;6;-2;0.0777806585;0.000587024
04011;2015/07/04 00:00:00.000;57;53;4;1.4104226082;0.010644701
04015;2015/07/04 00:00:00.000;30;29;1;0.197044335;0.0014871273
04017;2015/07/04 00:00:00.000;2;4;-2;0.0207415089;0.0001565397
04022;2015/07/04 00:00:00.000;9;9;0;0.088151413;0.0006652938
04029;2015/07/04 00:00:00.000;9;10;-1;0.2281565984;0.0017219369
04037;2015/07/04 00:00:00.000;18;26;-8;0.2437127301;0.0018393417
04040;2015/07/04 00:00:00.000;58;54;4;0.4718693285;0.0035612786
04041;2015/07/04 00:00:00.000;11;11;0;0.1607466943;0.0012131828
04046;2015/07/04 00:00:00.000;88;110;-22;1.2652320456;0.009548923
04047;2015/07/04 00:00:00.000;6;5;1;0.0985221675;0.0007435637
04050;2015/07/04 00:00:00.000;3;2;1;0.0570391496;0.0004304842
04051;2015/07/04 00:00:00.000;9;17;-8;0.088151413;0.0006652938
04061;2015/07/04 00:00:00.000;8;6;2;0.1140782992;0.0008609685
04062;2015/07/04 00:00:00.000;73;80;-7;1.2548612912;0.0094706531
04068;2015/07/04 00:00:00.000;3;3;0;0.0518537724;0.0003913493
04071;2015/07/04 00:00:00.000;63;71;-8;0.4770547057;0.0036004136
04074;2015/07/04 00:00:00.000;12;12;0;1.4985740213;0.0113099948
04079;2015/07/04 00:00:00.000;34;29;5;0.8244749806;0.0062224539
04083;2015/07/04 00:00:00.000;11;14;-3;0.2229712212;0.001682802
04084;2015/07/04 00:00:00.000;38;43;-5;0.5807622505;0.0043831122
04088;2015/07/04 00:00:00.000;2;2;0;0.0985221675;0.0007435637
04090;2015/07/04 00:00:00.000;141;158;-17;1.5296862847;0.0115448044
04093;2015/07/04 00:00:00.000;10;7;3;0.5444646098;0.0041091677
04101;2015/07/04 00:00:00.000;25;29;-4;1.4622763806;0.0110360503
04105;2015/07/04 00:00:00.000;34;33;1;1.1926367643;0.0090010339
04106;2015/07/04 00:00:00.000;68;62;6;2.7638060669;0.0208589178
04107;2015/07/04 00:00:00.000;46;43;3;1.2807881773;0.0096663278
04108;2015/07/04 00:00:00.000;7;6;1;0.2592688618;0.0019567465
04109;2015/07/04 00:00:00.000;2;2;0;0.0725952813;0.000547889
04110;2015/07/04 00:00:00.000;11;11;0;0.1814882033;0.0013697226
04220;2015/07/04 00:00:00.000;18;20;-2;0.1711174488;0.0012914527
04221;2015/07/04 00:00:00.000;2;2;0;0.0311122634;0.0002348096
04224;2015/07/04 00:00:00.000;38;42;-4;0.0570391496;0.0004304842
04236;2015/07/04 00:00:00.000;21;24;-3;0.3526056521;0.0026611753
04239;2015/07/04 00:00:00.000;14;13;1;0.176302826;0.0013305876
04240;2015/07/04 00:00:00.000;118;137;-19;0.8711433757;0.0065746683
04252;2015/07/04 00:00:00.000;7;8;-1;0.1037075447;0.0007826986
04256;2015/07/04 00:00:00.000;7;8;-1;0.0829660358;0.0006261589
04257;2015/07/04 00:00:00.000;6;6;0;0.108892922;0.0008218335
04261;2015/07/04 00:00:00.000;16;24;-8;0.2177858439;0.0016436671
04268;2015/07/04 00:00:00.000;11;11;0;0.2022297122;0.0015262623
04275;2015/07/04 00:00:00.000;4;4;0;0.0207415089;0.0001565397
04276;2015/07/04 00:00:00.000;2;2;0;0.3422348976;0.0025829054
04280;2015/07/04 00:00:00.000;43;51;-8;0.2540834846;0.0019176116
04281;2015/07/04 00:00:00.000;13;13;0;0.1711174488;0.0012914527
04285;2015/07/04 00:00:00.000;2;2;0;0.0155561317;0.0001174048
04290;2015/07/04 00:00:00.000;3;3;0;0.0414830179;0.0003130794
04344;2015/07/04 00:00:00.000;3;3;0;0.0518537724;0.0003913493
04347;2015/07/04 00:00:00.000;6;6;0;0.1037075447;0.0007826986
04348;2015/07/04 00:00:00.000;11;11;0;0.2074150894;0.0015653972
04351;2015/07/04 00:00:00.000;19;17;2;0.0933367903;0.0007044287
04352;2015/07/04 00:00:00.000;16;15;1;0.0985221675;0.0007435637
04355;2015/07/04 00:00:00.000;8;10;-2;0.0829660358;0.0006261589
04357;2015/07/04 00:00:00.000;25;24;1;0.2437127301;0.0018393417
04363;2015/07/04 00:00:00.000;4;3;1;0.1296344309;0.0009783733
04406;2015/07/04 00:00:00.000;8;10;-2;0.0622245268;0.0004696192
04408;2015/07/04 00:00:00.000;1;1;0;0.0155561317;0.0001174048
04412;2015/07/04 00:00:00.000;38;39;-1;1.2704174229;0.0095880579
04413;2015/07/04 00:00:00.000;1;1;0;0.0503834742;0.0003500413
04416;2015/07/04 00:00:00.000;58;70;-12;0.1348198081;0.0010175082
04421;2015/07/04 00:00:00.000;2;3;-1;0.1037075447;0.0007826986
04422;2015/07/04 00:00:00.000;4;3;1;0.0103707545;0.0000782699
04426;2015/07/04 00:00:00.000;33;35;-2;0.0466683951;0.0003522144
04427;2015/07/04 00:00:00.000;2;2;0;0.0674099041;0.0005087541
04429;2015/07/04 00:00:00.000;84;110;-26;0.5911330049;0.004461382
04434;2015/07/04 00:00:00.000;3;2;1;0.0259268862;0.0001956747
04435;2015/07/04 00:00:00.000;3;3;0;0.0155561317;0.0001174048
04443;2015/07/04 00:00:00.000;45;78;-33;0.1400051854;0.0010566431
04444;2015/07/04 00:00:00.000;59;63;-4;0.8711433757;0.0065746683
04449;2015/07/04 00:00:00.000;4;6;-2;0.0622245268;0.0004696192
04450;2015/07/04 00:00:00.000;4;9;-5;0.0414830179;0.0003130794
04455;2015/07/04 00:00:00.000;7;7;0;0.0155561317;0.0001174048
04459;2015/07/04 00:00:00.000;2;2;0;0.0051853772;0.0000391349
04460;2015/07/04 00:00:00.000;3;4;-1;0.0155561317;0.0001174048
04463;2015/07/04 00:00:00.000;34;40;-6;0.1451905626;0.001095778
04464;2015/07/04 00:00:00.000;4;11;-7;0.0259268862;0.0001956747
04471;2015/07/04 00:00:00.000;1;1;0;0.0311122634;0.0002348096
04472;2015/07/04 00:00:00.000;11;15;-4;0.0829660358;0.0006261589
04476;2015/07/04 00:00:00.000;6;7;-1;0.0777806585;0.000587024
04478;2015/07/04 00:00:00.000;4;2;2;0.088151413;0.0006652938
04487;2015/07/04 00:00:00.000;22;14;8;0.0777806585;0.000587024
04496;2015/07/04 00:00:00.000;31;39;-8;0.1192636764;0.0009001034
04497;2015/07/04 00:00:00.000;20;22;-2;0.0051853772;0.0000391349
04537;2015/07/04 00:00:00.000;9;6;3;0.4303863106;0.0032481992
04538;2015/07/04 00:00:00.000;13;13;0;0.7000259269;0.0052832156
04544;2015/07/04 00:00:00.000;3;3;0;0.1711174488;0.0012914527
04547;2015/07/04 00:00:00.000;5;5;0;0.1140782992;0.0008609685
04551;2015/07/04 00:00:00.000;5;4;1;0.0933367903;0.0007044287
04556;2015/07/04 00:00:00.000;12;11;1;0.1037075447;0.0007826986
04572;2015/07/04 00:00:00.000;31;28;3;0.4407570651;0.0033264691
04576;2015/07/04 00:00:00.000;14;10;4;0.0829660358;0.0006261589
04606;2015/07/04 00:00:00.000;9;10;-1;0.0259268862;0.0001956747
04607;2015/07/04 00:00:00.000;2;2;0;0.1451905626;0.001095778
04612;2015/07/04 00:00:00.000;2;2;0;0.0570391496;0.0004304842
04616;2015/07/04 00:00:00.000;7;8;-1;0.2281565984;0.0017219369
04617;2015/07/04 00:00:00.000;1;1;0;0.0466683951;0.0003522144
04623;2015/07/04 00:00:00.000;2;2;0;0.0155561317;0.0001174048
04624;2015/07/04 00:00:00.000;1;1;0;0.0103707545;0.0000782699
04628;2015/07/04 00:00:00.000;2;2;0;0.0466683951;0.0003522144
04631;2015/07/04 00:00:00.000;5;8;-3;0.2437127301;0.0018393417
04634;2015/07/04 00:00:00.000;52;60;-8;0.1037075447;0.0007826986
04640;2015/07/04 00:00:00.000;10;10;0;0.1296344309;0.0009783733
04642;2015/07/04 00:00:00.000;2;2;0;0.0051853772;0.0000391349
04652;2015/07/04 00:00:00.000;8;10;-2;0.1451905626;0.001095778
04653;2015/07/04 00:00:00.000;3;3;0;0.0362976407;0.0002739445
04655;2015/07/04 00:00:00.000;5;5;0;0.0829660358;0.0006261589
04660;2015/07/04 00:00:00.000;17;14;3;0.2488981073;0.0018784766
04666;2015/07/04 00:00:00.000;2;4;-2;0.1192636764;0.0009001034
04671;2015/07/04 00:00:00.000;4;7;-3;0.2281565984;0.0017219369
04676;2015/07/04 00:00:00.000;2;2;0;0.1555613171;0.0011740479
04677;2015/07/04 00:00:00.000;5;5;0;0.0259268862;0.0001956747
04679;2015/07/04 00:00:00.000;8;8;0;0.1244490537;0.0009392383
04684;2015/07/04 00:00:00.000;4;4;0;0.264454239;0.0019958814
04685;2015/07/04 00:00:00.000;6;5;1;0.176302826;0.0013305876
04691;2015/07/04 00:00:00.000;2;3;-1;0.0207415089;0.0001565397
04732;2015/07/04 00:00:00.000;5;5;0;0.0223926552;0.0001555739
04733;2015/07/04 00:00:00.000;1;1;0;0.0051853772;0.0000391349
04736;2015/07/04 00:00:00.000;72;66;6;0.5081669691;0.0038352232
04740;2015/07/04 00:00:00.000;2;2;0;0.0207415089;0.0001565397
04745;2015/07/04 00:00:00.000;1;2;-1;0.0207415089;0.0001565397
04746;2015/07/04 00:00:00.000;2;2;0;0.0103707545;0.0000782699
04756;2015/07/04 00:00:00.000;1;1;0;0.3111226342;0.0023480958
04760;2015/07/04 00:00:00.000;1;1;0;0.0414830179;0.0003130794
04765;2015/07/04 00:00:00.000;12;12;0;0.0103707545;0.0000782699
04766;2015/07/04 00:00:00.000;1;1;0;0.0051853772;0.0000391349
04772;2015/07/04 00:00:00.000;1;1;0;0.0051853772;0.0000391349
04779;2015/07/04 00:00:00.000;3;3;0;0.0414830179;0.0003130794
04783;2015/07/04 00:00:00.000;1;1;0;0.0259268862;0.0001956747
04786;2015/07/04 00:00:00.000;1;1;0;0.0155561317;0.0001174048
04843;2015/07/04 00:00:00.000;28;30;-2;1.1770806326;0.0088836292
04854;2015/07/04 00:00:00.000;4;5;-1;0.0829660358;0.0006261589
04859;2015/07/04 00:00:00.000;4;4;0;0.0466683951;0.0003522144
04860;2015/07/04 00:00:00.000;18;21;-3;0.3785325382;0.0028568499
04863;2015/07/04 00:00:00.000;6;7;-1;0.4355716878;0.0032873341
04864;2015/07/04 00:00:00.000;14;15;-1;0.2177858439;0.0016436671
04910;2015/07/04 00:00:00.000;1;1;0;0.0777806585;0.000587024
04917;2015/07/04 00:00:00.000;8;9;-1;0.1555613171;0.0011740479
04923;2015/07/04 00:00:00.000;1;1;0;0.0051853772;0.0000391349
04924;2015/07/04 00:00:00.000;2;3;-1;0.0051853772;0.0000391349
04928;2015/07/04 00:00:00.000;7;8;-1;0.0777806585;0.000587024
04929;2015/07/04 00:00:00.000;7;6;1;0.0207415089;0.0001565397
04936;2015/07/04 00:00:00.000;6;5;1;0.0777806585;0.000587024
04941;2015/07/04 00:00:00.000;18;20;-2;0.0622245268;0.0004696192
04945;2015/07/04 00:00:00.000;10;8;2;0.0207415089;0.0001565397
04949;2015/07/04 00:00:00.000;17;16;1;0.0414830179;0.0003130794
04950;2015/07/04 00:00:00.000;6;7;-1;0.1555613171;0.0011740479
04955;2015/07/04 00:00:00.000;4;4;0;0.1140782992;0.0008609685
04961;2015/07/04 00:00:00.000;6;7;-1;0.0622245268;0.0004696192
04966;2015/07/04 00:00:00.000;26;36;-10;0.0674099041;0.0005087541
04967;2015/07/04 00:00:00.000;22;34;-12;0.0466683951;0.0003522144
04971;2015/07/04 00:00:00.000;6;7;-1;0.1296344309;0.0009783733
04976;2015/07/04 00:00:00.000;16;15;1;0.285195748;0.0021524212
04979;2015/07/04 00:00:00.000;6;7;-1;0.0311122634;0.0002348096
04981;2015/07/04 00:00:00.000;24;24;0;0.0933367903;0.0007044287
04982;2015/07/04 00:00:00.000;2;2;0;0.0111963276;0.000077787
04983;2015/07/04 00:00:00.000;1;1;0;0.0207415089;0.0001565397
04986;2015/07/04 00:00:00.000;6;4;2;0.0155561317;0.0001174048
04987;2015/07/04 00:00:00.000;8;8;0;0.0518537724;0.0003913493
05001;2015/07/04 00:00:00.000;28;31;-3;0.7446268404;0.0017219369
05030;2015/07/04 00:00:00.000;1;1;0;0.0338466746;0.0000782699
05032;2015/07/04 00:00:00.000;9;7;2;0.6261634794;0.0014479924
05033;2015/07/04 00:00:00.000;14;15;-1;0.6938568286;0.0016045321
05034;2015/07/04 00:00:00.000;1;1;0;0.1015400237;0.0002348096
05035;2015/07/04 00:00:00.000;4;4;0;0.0169233373;0.0000391349
05036;2015/07/04 00:00:00.000;6;6;0;0.1523100355;0.0003522144
05037;2015/07/04 00:00:00.000;8;8;0;0.0338466746;0.0000782699
05038;2015/07/04 00:00:00.000;7;5;2;0.1692333728;0.0003913493
05039;2015/07/04 00:00:00.000;2;3;-1;0.0507700118;0.0001174048
05040;2015/07/04 00:00:00.000;2;3;-1;0.0507700118;0.0001174048
05041;2015/07/04 00:00:00.000;1;1;0;0.0677966102;0.0001555739
05043;2015/07/04 00:00:00.000;1;2;-1;0.0507700118;0.0001174048
05048;2015/07/04 00:00:00.000;5;6;-1;0.1692333728;0.0003913493
05051;2015/07/04 00:00:00.000;5;4;1;0.1353866983;0.0003130794
05055;2015/07/04 00:00:00.000;14;15;-1;0.660010154;0.0015262623
05058;2015/07/04 00:00:00.000;1;1;0;0.0338466746;0.0000782699
05062;2015/07/04 00:00:00.000;5;6;-1;0.2538500592;0.000587024
05065;2015/07/04 00:00:00.000;5;6;-1;0.1015400237;0.0002348096
05069;2015/07/04 00:00:00.000;2;2;0;0.1015400237;0.0002348096
05070;2015/07/04 00:00:00.000;3;3;0;0.0508474576;0.0001166804
05077;2015/07/04 00:00:00.000;4;5;-1;0.1353866983;0.0003130794
05079;2015/07/04 00:00:00.000;3;3;0;0.0507700118;0.0001174048
05083;2015/07/04 00:00:00.000;1;1;0;0.0846166864;0.0001956747
05089;2015/07/04 00:00:00.000;74;88;-14;0.9307835505;0.0021524212
05091;2015/07/04 00:00:00.000;34;32;2;1.9123371129;0.0044222471
05101;2015/07/04 00:00:00.000;13;16;-3;1.4892536808;0.0034438739
05146;2015/07/04 00:00:00.000;2;3;-1;0.2369267219;0.000547889
05151;2015/07/04 00:00:00.000;3;4;-1;0.1353866983;0.0003130794
05154;2015/07/04 00:00:00.000;1;1;0;0.0507700118;0.0001174048
05155;2015/07/04 00:00:00.000;7;8;-1;0.4569301066;0.0010566431
05158;2015/07/04 00:00:00.000;1;1;0;0.4907767812;0.001134913
05201;2015/07/04 00:00:00.000;39;47;-8;2.0646471484;0.0047744615
05250;2015/07/04 00:00:00.000;88;108;-20;1.2354036216;0.0028568499
05251;2015/07/04 00:00:00.000;28;33;-5;2.0138771366;0.0046570567
05252;2015/07/04 00:00:00.000;1;1;0;0.0169233373;0.0000391349
05255;2015/07/04 00:00:00.000;38;43;-5;0.8800135387;0.0020350164
05257;2015/07/04 00:00:00.000;3;3;0;0.1861567101;0.0004304842
05261;2015/07/04 00:00:00.000;5;4;1;0.6261634794;0.0014479924
05262;2015/07/04 00:00:00.000;7;8;-1;0.7953968523;0.0018393417
05341;2015/07/04 00:00:00.000;2;2;0;0.0507700118;0.0001174048
05342;2015/07/04 00:00:00.000;5;5;0;0.0169233373;0.0000391349
05345;2015/07/04 00:00:00.000;16;16;0;0.4400067693;0.0010175082
05346;2015/07/04 00:00:00.000;26;22;4;0.3215434084;0.0007435637
05352;2015/07/04 00:00:00.000;3;3;0;0.0846166864;0.0001956747
05353;2015/07/04 00:00:00.000;9;10;-1;0.1353866983;0.0003130794
05355;2015/07/04 00:00:00.000;8;10;-2;0.3892367575;0.0009001034
05356;2015/07/04 00:00:00.000;26;32;-6;0.9307835505;0.0021524212
05359;2015/07/04 00:00:00.000;11;12;-1;0.2538500592;0.000587024
05360;2015/07/04 00:00:00.000;10;12;-2;0.3723134202;0.0008609685
05363;2015/07/04 00:00:00.000;25;24;1;1.2354036216;0.0028568499
05403;2015/07/04 00:00:00.000;47;56;-9;3.3846674564;0.007826986
05404;2015/07/04 00:00:00.000;12;15;-3;0.5753934676;0.0013305876
05440;2015/07/04 00:00:00.000;46;50;-4;0.2707733965;0.0006261589
05444;2015/07/04 00:00:00.000;3;5;-2;0.2707733965;0.0006261589
05445;2015/07/04 00:00:00.000;28;39;-11;1.5400236927;0.0035612786
05448;2015/07/04 00:00:00.000;4;5;-1;0.0169233373;0.0000391349
05452;2015/07/04 00:00:00.000;57;63;-6;2.9108140125;0.006731208
05456;2015/07/04 00:00:00.000;6;6;0;0.3215434084;0.0007435637
05457;2015/07/04 00:00:00.000;9;9;0;0.1353866983;0.0003130794
05461;2015/07/04 00:00:00.000;8;12;-4;0.3553900829;0.0008218335
05464;2015/07/04 00:00:00.000;5;5;0;0.3553900829;0.0008218335
05465;2015/07/04 00:00:00.000;6;9;-3;0.7615501777;0.0017610719
05468;2015/07/04 00:00:00.000;35;42;-7;1.1000169233;0.0025437705
05472;2015/07/04 00:00:00.000;6;4;2;0.0846166864;0.0001956747
05473;2015/07/04 00:00:00.000;2;2;0;0.118463361;0.0002739445
05478;2015/07/04 00:00:00.000;43;49;-6;1.6415637164;0.0037960882
05486;2015/07/04 00:00:00.000;11;14;-3;0.4230834321;0.0009783733
05489;2015/07/04 00:00:00.000;11;13;-2;0.3215434084;0.0007435637
05495;2015/07/04 00:00:00.000;108;92;16;1.6077170418;0.0037178184
05641;2015/07/04 00:00:00.000;60;66;-6;2.6231172787;0.0060659142
05647;2015/07/04 00:00:00.000;3;4;-1;0.2030800474;0.0004696192
05649;2015/07/04 00:00:00.000;1;1;0;0.0338466746;0.0000782699
05650;2015/07/04 00:00:00.000;2;2;0;0.0676933491;0.0001565397
05654;2015/07/04 00:00:00.000;2;2;0;0.0169491525;0.0000388935
05655;2015/07/04 00:00:00.000;15;22;-7;0.2200033847;0.0005087541
05660;2015/07/04 00:00:00.000;9;8;1;0.4400067693;0.0010175082
05661;2015/07/04 00:00:00.000;41;51;-10;0.5584701303;0.0012914527
05672;2015/07/04 00:00:00.000;50;58;-8;2.8600440007;0.0066138032
05674;2015/07/04 00:00:00.000;29;41;-12;0.3723134202;0.0008609685
05675;2015/07/04 00:00:00.000;2;2;0;0.1015400237;0.0002348096
05679;2015/07/04 00:00:00.000;5;5;0;0.2876967338;0.0006652938
05680;2015/07/04 00:00:00.000;9;14;-5;0.4400067693;0.0010175082
05730;2015/07/04 00:00:00.000;1;1;0;0.0508474576;0.0001166804
05733;2015/07/04 00:00:00.000;144;156;-12;0.8461668641;0.0019567465
05734;2015/07/04 00:00:00.000;4;4;0;0.0507700118;0.0001174048
05739;2015/07/04 00:00:00.000;7;8;-1;0.1353866983;0.0003130794
05743;2015/07/04 00:00:00.000;38;36;2;0.3892367575;0.0009001034
05748;2015/07/04 00:00:00.000;2;2;0;0.0162786912;0.0000367031
05757;2015/07/04 00:00:00.000;3;4;-1;0.0169233373;0.0000391349
05758;2015/07/04 00:00:00.000;5;4;1;0.2030800474;0.0004696192
05763;2015/07/04 00:00:00.000;20;28;-8;0.4061600948;0.0009392383
05764;2015/07/04 00:00:00.000;7;6;1;0.4738534439;0.001095778
05769;2015/07/04 00:00:00.000;2;2;0;0.2707733965;0.0006261589
05774;2015/07/04 00:00:00.000;9;9;0;0.4061600948;0.0009392383
05775;2015/07/04 00:00:00.000;1;1;0;0.1692333728;0.0003913493
05819;2015/07/04 00:00:00.000;80;98;-18;0.7107801658;0.0016436671
05820;2015/07/04 00:00:00.000;2;2;0;0.0676933491;0.0001565397
05824;2015/07/04 00:00:00.000;1;1;0;0.0338466746;0.0000782699
05829;2015/07/04 00:00:00.000;9;6;3;0.0676933491;0.0001565397
05830;2015/07/04 00:00:00.000;7;7;0;0.1692333728;0.0003913493
05836;2015/07/04 00:00:00.000;1;1;0;0.0169233373;0.0000391349
05837;2015/07/04 00:00:00.000;1;1;0;0.0508474576;0.0001166804
05841;2015/07/04 00:00:00.000;5;5;0;0.1523100355;0.0003522144
05846;2015/07/04 00:00:00.000;5;5;0;0.1692333728;0.0003913493
05847;2015/07/04 00:00:00.000;4;3;1;0.0169233373;0.0000391349
05851;2015/07/04 00:00:00.000;23;24;-1;0.3384667456;0.0007826986
05853;2015/07/04 00:00:00.000;4;4;0;0.2369267219;0.000547889
05859;2015/07/04 00:00:00.000;36;34;2;0.1015400237;0.0002348096
05862;2015/07/04 00:00:00.000;3;4;-1;0.1523100355;0.0003522144
05871;2015/07/04 00:00:00.000;7;7;0;0.0846166864;0.0001956747
05872;2015/07/04 00:00:00.000;5;5;0;0.0676933491;0.0001565397
05875;2015/07/04 00:00:00.000;1;1;0;0.0338466746;0.0000782699
05901;2015/07/04 00:00:00.000;3;2;1;0.0162786912;0.0000367031
05904;2015/07/04 00:00:00.000;1;1;0;0.0169491525;0.0000388935
05905;2015/07/04 00:00:00.000;2;2;0;0.0846166864;0.0001956747
06010;2015/07/04 00:00:00.000;184;174;10;1.1267889031;0.0175324487
06013;2015/07/04 00:00:00.000;48;53;-5;0.354636686;0.0055180252
06016;2015/07/04 00:00:00.000;24;23;1;0.0679091526;0.0010566431
06018;2015/07/04 00:00:00.000;17;10;7;0.0578485374;0.0009001034
06019;2015/07/04 00:00:00.000;152;134;18;0.2339093036;0.0036395485
06021;2015/07/04 00:00:00.000;2;2;0;0.0201212304;0.0003130794
06023;2015/07/04 00:00:00.000;3;2;1;0.025151538;0.0003913493
06024;2015/07/04 00:00:00.000;1;2;-1;0.0176060766;0.0002739445
06026;2015/07/04 00:00:00.000;20;19;1;0.1106667673;0.0017219369
06027;2015/07/04 00:00:00.000;4;4;0;0.0050303076;0.0000782699
06031;2015/07/04 00:00:00.000;6;6;0;0.050303076;0.0007826986
06035;2015/07/04 00:00:00.000;26;21;5;0.1483940743;0.0023089609
06037;2015/07/04 00:00:00.000;44;50;-6;0.5986066048;0.0093141134
06040;2015/07/04 00:00:00.000;106;96;10;0.8727583692;0.0135798208
06042;2015/07/04 00:00:00.000;74;70;4;0.5407580674;0.00841401
06043;2015/07/04 00:00:00.000;25;20;5;0.1307879977;0.0020350164
06052;2015/07/04 00:00:00.000;16;18;-2;0.2112729193;0.0032873341
06053;2015/07/04 00:00:00.000;58;62;-4;0.3948791469;0.006144184
06060;2015/07/04 00:00:00.000;14;12;2;0.050303076;0.0007826986
06063;2015/07/04 00:00:00.000;20;20;0;0.0352121532;0.000547889
06066;2015/07/04 00:00:00.000;109;111;-2;0.633818758;0.0098620024
06067;2015/07/04 00:00:00.000;60;60;0;0.4401519153;0.0068486128
06070;2015/07/04 00:00:00.000;69;80;-11;0.5784853744;0.0090010339
06071;2015/07/04 00:00:00.000;43;41;2;0.2490002264;0.0038743581
06073;2015/07/04 00:00:00.000;27;25;2;0.1685153047;0.0026220403
06074;2015/07/04 00:00:00.000;90;92;-2;0.7620916019;0.0118578838
06078;2015/07/04 00:00:00.000;45;44;1;0.4250609925;0.0066138032
06084;2015/07/04 00:00:00.000;54;57;-3;0.1986971503;0.0030916595
06088;2015/07/04 00:00:00.000;70;74;-4;0.1031213059;0.0016045321
06089;2015/07/04 00:00:00.000;17;16;1;0.0402424608;0.0006261589
06091;2015/07/04 00:00:00.000;1;1;0;0.0075454614;0.0001174048
06092;2015/07/04 00:00:00.000;12;14;-2;0.0880303831;0.0013697226
06095;2015/07/04 00:00:00.000;100;97;3;0.7545461405;0.0117404791
06096;2015/07/04 00:00:00.000;37;33;4;0.2464850726;0.0038352232
06103;2015/07/04 00:00:00.000;6;3;3;0.0477879222;0.0007435637
06106;2015/07/04 00:00:00.000;24;21;3;0.3621821474;0.0056354299
06107;2015/07/04 00:00:00.000;71;70;1;0.975879675;0.0151843529
06110;2015/07/04 00:00:00.000;37;39;-2;0.4728489147;0.0073573669
06111;2015/07/04 00:00:00.000;114;112;2;1.0463039815;0.016280131
06117;2015/07/04 00:00:00.000;76;78;-2;0.6187278352;0.0096271928
06118;2015/07/04 00:00:00.000;79;78;1;0.5105762217;0.0079443908
06234;2015/07/04 00:00:00.000;28;30;-2;0.1232425363;0.0019176116
06235;2015/07/04 00:00:00.000;13;11;2;0.0176060766;0.0002739445
06237;2015/07/04 00:00:00.000;30;28;2;0.291757841;0.0045396519
06241;2015/07/04 00:00:00.000;26;23;3;0.1182122287;0.0018393417
06242;2015/07/04 00:00:00.000;7;6;1;0.0301818456;0.0004696192
06247;2015/07/04 00:00:00.000;9;8;1;0.0352121532;0.000547889
06249;2015/07/04 00:00:00.000;28;25;3;0.2012123041;0.0031307944
06250;2015/07/04 00:00:00.000;28;28;0;0.1760607661;0.0027394451
06256;2015/07/04 00:00:00.000;10;11;-1;0.0352121532;0.000547889
06268;2015/07/04 00:00:00.000;19;21;-2;0.1408486129;0.0021915561
06278;2015/07/04 00:00:00.000;11;11;0;0.0402424608;0.0006261589
06279;2015/07/04 00:00:00.000;18;18;0;0.0704243064;0.001095778
06330;2015/07/04 00:00:00.000;13;12;1;0.0477879222;0.0007435637
06331;2015/07/04 00:00:00.000;16;14;2;0.1358183053;0.0021132862
06334;2015/07/04 00:00:00.000;10;10;0;0.1182122287;0.0018393417
06335;2015/07/04 00:00:00.000;32;31;1;0.1333031515;0.0020741513
06339;2015/07/04 00:00:00.000;35;37;-2;0.1936668427;0.0030133896
06340;2015/07/04 00:00:00.000;74;74;0;0.7067582183;0.0109969154
06351;2015/07/04 00:00:00.000;210;222;-12;0.367212455;0.0057136998
06353;2015/07/04 00:00:00.000;1;1;0;0.0100606152;0.0001565397
06355;2015/07/04 00:00:00.000;54;49;5;0.5382429136;0.0083748751
06357;2015/07/04 00:00:00.000;52;45;7;0.2867275334;0.004461382
06370;2015/07/04 00:00:00.000;25;29;-4;0.1282728439;0.0019958814
06371;2015/07/04 00:00:00.000;258;242;16;0.6287884504;0.0097837325
06374;2015/07/04 00:00:00.000;32;31;1;0.1282728439;0.0019958814
06375;2015/07/04 00:00:00.000;23;19;4;0.1483940743;0.0023089609
06379;2015/07/04 00:00:00.000;22;19;3;0.1685153047;0.0026220403
06380;2015/07/04 00:00:00.000;3;3;0;0.0075454614;0.0001174048
06385;2015/07/04 00:00:00.000;86;87;-1;0.5306974521;0.0082574703
06401;2015/07/04 00:00:00.000;39;39;0;0.3747579164;0.0058311046
06405;2015/07/04 00:00:00.000;132;127;5;1.229910209;0.0191369809
06410;2015/07/04 00:00:00.000;105;100;5;0.9431826756;0.0146755988
06415;2015/07/04 00:00:00.000;66;81;-15;0.4175155311;0.0064963984
06416;2015/07/04 00:00:00.000;56;54;2;0.4451822229;0.0069268826
06419;2015/07/04 00:00:00.000;31;35;-4;0.1433637667;0.002230691
06420;2015/07/04 00:00:00.000;15;15;0;0.1634849971;0.0025437705
06423;2015/07/04 00:00:00.000;38;36;2;0.2137880731;0.0033264691
06424;2015/07/04 00:00:00.000;73;80;-7;0.3873336855;0.0060267793
06441;2015/07/04 00:00:00.000;24;22;2;0.1307879977;0.0020350164
06447;2015/07/04 00:00:00.000;28;30;-2;0.1634849971;0.0025437705
06455;2015/07/04 00:00:00.000;14;13;1;0.1031213059;0.0016045321
06460;2015/07/04 00:00:00.000;164;179;-15;1.4789104354;0.023011339
06461;2015/07/04 00:00:00.000;65;65;0;0.316909379;0.0049310012
06468;2015/07/04 00:00:00.000;75;78;-3;0.6665157574;0.0103707565
06469;2015/07/04 00:00:00.000;20;13;7;0.0402424608;0.0006261589
06472;2015/07/04 00:00:00.000;16;15;1;0.1182122287;0.0018393417
06473;2015/07/04 00:00:00.000;87;85;2;0.6765763726;0.0105272962
06477;2015/07/04 00:00:00.000;59;55;4;0.3571518398;0.0055571601
06478;2015/07/04 00:00:00.000;87;79;8;0.2640911492;0.0041091677
06482;2015/07/04 00:00:00.000;55;52;3;0.2163032269;0.003365604
06483;2015/07/04 00:00:00.000;82;80;2;0.3395457632;0.0052832156
06489;2015/07/04 00:00:00.000;93;93;0;0.9985160593;0.0155365673
06510;2015/07/04 00:00:00.000;4;3;1;0.0452727684;0.0007044287
06511;2015/07/04 00:00:00.000;33;26;7;0.7143036797;0.0111143202
06513;2015/07/04 00:00:00.000;258;246;12;0.6111823738;0.009509788
06514;2015/07/04 00:00:00.000;81;78;3;0.3848185317;0.0059876443
06519;2015/07/04 00:00:00.000;5;5;0;0.1131819211;0.0017610719
06606;2015/07/04 00:00:00.000;81;77;4;0.6438793732;0.0100185421
06607;2015/07/04 00:00:00.000;6;6;0;0.0603636912;0.0009392383
06610;2015/07/04 00:00:00.000;30;23;7;0.3823033779;0.0059485094
06611;2015/07/04 00:00:00.000;119;110;9;1.0815161347;0.01682802
06704;2015/07/04 00:00:00.000;54;49;5;0.570939913;0.0088836292
06705;2015/07/04 00:00:00.000;90;85;5;0.3772730702;0.0058702395
06706;2015/07/04 00:00:00.000;19;20;-1;0.2439699188;0.0037960882
06708;2015/07/04 00:00:00.000;96;105;-9;0.7470006791;0.0116230743
06710;2015/07/04 00:00:00.000;14;14;0;0.2163032269;0.003365604
06751;2015/07/04 00:00:00.000;20;19;1;0.1282728439;0.0019958814
06752;2015/07/04 00:00:00.000;28;26;2;0.1131819211;0.0017610719
06754;2015/07/04 00:00:00.000;70;70;0;0.0955758445;0.0014871273
06757;2015/07/04 00:00:00.000;25;21;4;0.2037274579;0.0031699293
06763;2015/07/04 00:00:00.000;22;18;4;0.1333031515;0.0020741513
06770;2015/07/04 00:00:00.000;119;114;5;0.9909705979;0.0154191625
06778;2015/07/04 00:00:00.000;9;9;0;0.025151538;0.0003913493
06779;2015/07/04 00:00:00.000;16;16;0;0.0830000755;0.0012914527
06783;2015/07/04 00:00:00.000;38;43;-5;0.1609698433;0.0025046355
06784;2015/07/04 00:00:00.000;37;28;9;0.1735456123;0.0027003102
06790;2015/07/04 00:00:00.000;191;194;-3;1.0865464423;0.0169062898
06791;2015/07/04 00:00:00.000;25;27;-2;0.2364244574;0.0036786834
06794;2015/07/04 00:00:00.000;13;10;3;0.0804849217;0.0012523178
06795;2015/07/04 00:00:00.000;52;48;4;0.2766669182;0.0043048423
06804;2015/07/04 00:00:00.000;72;68;4;0.6061520662;0.0094315182
06807;2015/07/04 00:00:00.000;25;22;3;0.3370306094;0.0052440806
06825;2015/07/04 00:00:00.000;60;64;-4;0.6841218341;0.010644701
06831;2015/07/04 00:00:00.000;90;97;-7;1.7404864307;0.0270813717
06840;2015/07/04 00:00:00.000;118;113;5;1.2500314394;0.0194500603
06850;2015/07/04 00:00:00.000;48;43;5;0.5659096054;0.0088053593
06851;2015/07/04 00:00:00.000;62;67;-5;0.7067582183;0.0109969154
06853;2015/07/04 00:00:00.000;33;33;0;0.2741517644;0.0042657074
06854;2015/07/04 00:00:00.000;51;45;6;0.7419703715;0.0115448044
06855;2015/07/04 00:00:00.000;18;16;2;0.1785759199;0.00277858
06870;2015/07/04 00:00:00.000;31;35;-4;0.4376367615;0.0068094779
06878;2015/07/04 00:00:00.000;28;33;-5;0.3496063784;0.0054397553
06883;2015/07/04 00:00:00.000;54;55;-1;0.3345154556;0.0052049457
06896;2015/07/04 00:00:00.000;63;90;-27;0.2842123796;0.0044222471
06897;2015/07/04 00:00:00.000;87;74;13;0.7243642949;0.0112708599
06902;2015/07/04 00:00:00.000;135;136;-1;1.8662441208;0.0290381182
06903;2015/07/04 00:00:00.000;84;73;11;0.8249704469;0.0128362571
06905;2015/07/04 00:00:00.000;55;58;-3;0.5407580674;0.00841401
06907;2015/07/04 00:00:00.000;28;32;-4;0.241454765;0.0037569533
07001;2015/07/04 00:00:00.000;24;26;-2;0.0604476683;0.0026611753
07002;2015/07/04 00:00:00.000;89;88;1;0.7182605295;0.0316210236
07003;2015/07/04 00:00:00.000;90;86;4;0.6195886003;0.0272770463
07004;2015/07/04 00:00:00.000;17;17;0;0.0924493751;0.0040700327
07005;2015/07/04 00:00:00.000;48;55;-7;0.1822319413;0.0080226607
07006;2015/07/04 00:00:00.000;348;362;-14;0.3137945135;0.0138146304
07008;2015/07/04 00:00:00.000;25;32;-7;0.1057834196;0.0046570567
07009;2015/07/04 00:00:00.000;26;27;-1;0.1297846996;0.0057136998
07010;2015/07/04 00:00:00.000;83;75;8;0.2906821697;0.0127971222
07011;2015/07/04 00:00:00.000;53;55;-2;0.342240475;0.0150669481
07012;2015/07/04 00:00:00.000;29;29;0;0.163564279;0.0072008272
07013;2015/07/04 00:00:00.000;74;83;-9;0.4275783597;0.0188239014
07014;2015/07/04 00:00:00.000;14;12;2;0.0942272477;0.0041483026
07017;2015/07/04 00:00:00.000;53;49;4;0.3040162142;0.0133841461
07018;2015/07/04 00:00:00.000;39;37;2;0.1653421516;0.007279097
07022;2015/07/04 00:00:00.000;25;24;1;0.0791153306;0.0034830088
07023;2015/07/04 00:00:00.000;18;20;-2;0.1235621455;0.0054397553
07024;2015/07/04 00:00:00.000;135;145;-10;0.6853698864;0.0301730312
07026;2015/07/04 00:00:00.000;49;50;-1;0.2755702526;0.0121318284
07027;2015/07/04 00:00:00.000;9;7;2;0.0622255409;0.0027394451
07028;2015/07/04 00:00:00.000;20;21;-1;0.1804540687;0.0079443908
07029;2015/07/04 00:00:00.000;32;30;2;0.0960051203;0.0042265725
07030;2015/07/04 00:00:00.000;152;173;-21;2.0276636976;0.0892667758
07031;2015/07/04 00:00:00.000;27;27;0;0.2008996035;0.0088444942
07032;2015/07/04 00:00:00.000;30;36;-6;0.1928991768;0.0084922799
07035;2015/07/04 00:00:00.000;48;45;3;0.0835600121;0.0036786834
07036;2015/07/04 00:00:00.000;89;93;-4;0.3475740928;0.0153017577
07039;2015/07/04 00:00:00.000;90;86;4;0.5084715629;0.0223851801
07040;2015/07/04 00:00:00.000;49;58;-9;0.5529183779;0.0243419266
07043;2015/07/04 00:00:00.000;30;29;1;0.3369068573;0.0148321385
07044;2015/07/04 00:00:00.000;45;44;1;0.2729034437;0.0120144236
07050;2015/07/04 00:00:00.000;36;38;-2;0.095116184;0.0041874375
07055;2015/07/04 00:00:00.000;42;39;3;0.1164506551;0.0051266759
07057;2015/07/04 00:00:00.000;19;17;2;0.0657812861;0.0028959848
07062;2015/07/04 00:00:00.000;68;116;-48;0.1075612922;0.0047353266
07065;2015/07/04 00:00:00.000;73;71;2;0.1875655591;0.0082574703
07066;2015/07/04 00:00:00.000;33;30;3;0.1760093872;0.0077487162
07069;2015/07/04 00:00:00.000;31;30;1;0.0888936299;0.003913493
07070;2015/07/04 00:00:00.000;49;45;4;0.2746813163;0.0120926934
07074;2015/07/04 00:00:00.000;7;5;2;0.0142229808;0.0006261589
07075;2015/07/04 00:00:00.000;31;28;3;0.1777872598;0.007826986
07077;2015/07/04 00:00:00.000;7;8;-1;0.0204455349;0.0009001034
07078;2015/07/04 00:00:00.000;76;79;-3;0.300460469;0.0132276064
07082;2015/07/04 00:00:00.000;18;16;2;0.0568919231;0.0025046355
07083;2015/07/04 00:00:00.000;128;141;-13;0.850712038;0.0374521282
07088;2015/07/04 00:00:00.000;6;6;0;0.0080004267;0.0003522144
07090;2015/07/04 00:00:00.000;69;76;-7;0.5520294416;0.0243027917
07093;2015/07/04 00:00:00.000;312;332;-20;0.5858090209;0.025789919
07094;2015/07/04 00:00:00.000;89;89;0;0.2631251445;0.0115839393
07102;2015/07/04 00:00:00.000;2;2;0;0.0497804327;0.0021915561
07106;2015/07/04 00:00:00.000;32;32;0;0.172453642;0.0075921765
07107;2015/07/04 00:00:00.000;31;31;0;0.1475634256;0.0064963984
07110;2015/07/04 00:00:00.000;71;75;-4;0.3893540989;0.0171410994
07111;2015/07/04 00:00:00.000;47;44;3;0.2115668391;0.0093141134
07114;2015/07/04 00:00:00.000;7;8;-1;0.0284459616;0.0012523178
07202;2015/07/04 00:00:00.000;15;21;-6;0.1600085338;0.0070442874
07203;2015/07/04 00:00:00.000;48;49;-1;0.2631251445;0.0115839393
07204;2015/07/04 00:00:00.000;24;25;-1;0.1440076804;0.0063398587
07205;2015/07/04 00:00:00.000;30;30;0;0.1937881131;0.0085314148
07305;2015/07/04 00:00:00.000;79;76;3;0.7431507458;0.0327168016
07306;2015/07/04 00:00:00.000;38;38;0;0.6249222181;0.0275118559
07310;2015/07/04 00:00:00.000;10;10;0;0.1422298078;0.0062615888
07410;2015/07/04 00:00:00.000;86;93;-7;0.360019201;0.0158496467
07416;2015/07/04 00:00:00.000;19;22;-3;0.0542251142;0.0023872307
07418;2015/07/04 00:00:00.000;9;6;3;0.0160008534;0.0007044287
07419;2015/07/04 00:00:00.000;58;59;-1;0.1004498018;0.0044222471
07423;2015/07/04 00:00:00.000;11;16;-5;0.0435578786;0.0019176116
07424;2015/07/04 00:00:00.000;218;258;-40;0.2577915267;0.0113491298
07435;2015/07/04 00:00:00.000;17;17;0;0.026668089;0.0011740479
07436;2015/07/04 00:00:00.000;45;49;-4;0.1520081071;0.0066920731
07439;2015/07/04 00:00:00.000;9;7;2;0.0124451082;0.000547889
07440;2015/07/04 00:00:00.000;15;18;-3;0.0853378847;0.0037569533
07444;2015/07/04 00:00:00.000;29;26;3;0.1066723559;0.0046961916
07446;2015/07/04 00:00:00.000;61;61;0;0.2746813163;0.0120926934
07456;2015/07/04 00:00:00.000;45;43;2;0.1680089605;0.0073965018
07457;2015/07/04 00:00:00.000;20;17;3;0.0311127705;0.0013697226
07462;2015/07/04 00:00:00.000;47;46;1;0.1377851263;0.0060659142
07463;2015/07/04 00:00:00.000;40;37;3;0.0986719292;0.0043439773
07501;2015/07/04 00:00:00.000;31;28;3;0.1422298078;0.0062615888
07502;2015/07/04 00:00:00.000;23;27;-4;0.0648923498;0.0028568499
07506;2015/07/04 00:00:00.000;44;46;-2;0.1440076804;0.0063398587
07512;2015/07/04 00:00:00.000;38;34;4;0.1360072537;0.0059876443
07601;2015/07/04 00:00:00.000;91;83;8;0.3946877167;0.017375909
07605;2015/07/04 00:00:00.000;18;23;-5;0.1324515085;0.0058311046
07606;2015/07/04 00:00:00.000;5;6;-1;0.0133340445;0.000587024
07620;2015/07/04 00:00:00.000;12;17;-5;0.2755702526;0.0121318284
07621;2015/07/04 00:00:00.000;63;65;-2;0.3235728128;0.0142451146
07626;2015/07/04 00:00:00.000;33;37;-4;0.1475634256;0.0064963984
07627;2015/07/04 00:00:00.000;19;24;-5;0.068448095;0.0030133896
07631;2015/07/04 00:00:00.000;73;74;-1;0.2729034437;0.0120144236
07632;2015/07/04 00:00:00.000;32;30;2;0.0702259676;0.0030916595
07641;2015/07/04 00:00:00.000;17;18;-1;0.050669369;0.002230691
07642;2015/07/04 00:00:00.000;32;34;-2;0.1324515085;0.0058311046
07646;2015/07/04 00:00:00.000;32;30;2;0.1466744893;0.0064572635
07647;2015/07/04 00:00:00.000;21;22;-1;0.0524472416;0.0023089609
07652;2015/07/04 00:00:00.000;59;60;-1;0.3244617491;0.0142842495
07657;2015/07/04 00:00:00.000;21;25;-4;0.0791153306;0.0034830088
07660;2015/07/04 00:00:00.000;19;17;2;0.1235621455;0.0054397553
07666;2015/07/04 00:00:00.000;99;107;-8;0.5004711362;0.0220329657
07670;2015/07/04 00:00:00.000;79;83;-4;0.336017921;0.0147930036
07677;2015/07/04 00:00:00.000;35;29;6;0.0586697957;0.0025829054
07704;2015/07/04 00:00:00.000;24;27;-3;0.1102281011;0.0048527313
07712;2015/07/04 00:00:00.000;822;780;42;0.4578021939;0.0201544891
07718;2015/07/04 00:00:00.000;12;10;2;0.0346685157;0.0015262623
07719;2015/07/04 00:00:00.000;362;342;20;0.3449072839;0.0151843529
07723;2015/07/04 00:00:00.000;5;7;-2;0.0408910697;0.0018002068
07724;2015/07/04 00:00:00.000;250;226;24;0.2302345014;0.0101359469
07727;2015/07/04 00:00:00.000;68;62;6;0.0800042669;0.0035221437
07728;2015/07/04 00:00:00.000;170;164;6;0.6302558359;0.0277466655
07732;2015/07/04 00:00:00.000;30;27;3;0.095116184;0.0041874375
07733;2015/07/04 00:00:00.000;70;59;11;0.3724643092;0.0163975358
07738;2015/07/04 00:00:00.000;15;11;4;0.0826710758;0.0036395485
07739;2015/07/04 00:00:00.000;36;36;0;0.2044553487;0.0090010339
07746;2015/07/04 00:00:00.000;49;56;-7;0.27379238;0.0120535585
07747;2015/07/04 00:00:00.000;91;80;11;0.5209166711;0.0229330691
07750;2015/07/04 00:00:00.000;32;31;1;0.1351183174;0.0059485094
07751;2015/07/04 00:00:00.000;53;57;-4;0.2266787562;0.0099794072
07755;2015/07/04 00:00:00.000;18;21;-3;0.0320017068;0.0014088575
07756;2015/07/04 00:00:00.000;15;18;-3;0.1217842729;0.0053614854
07762;2015/07/04 00:00:00.000;54;53;1;0.2969047238;0.0130710667
07801;2015/07/04 00:00:00.000;24;24;0;0.1208953366;0.0053223505
07821;2015/07/04 00:00:00.000;84;69;15;0.1146727825;0.005048406
07826;2015/07/04 00:00:00.000;67;63;4;0.0640034135;0.002817715
07827;2015/07/04 00:00:00.000;32;26;6;0.0675591587;0.0029742547
07830;2015/07/04 00:00:00.000;102;84;18;0.1733425783;0.0076313114
07834;2015/07/04 00:00:00.000;57;62;-5;0.3377957936;0.0148712735
07836;2015/07/04 00:00:00.000;25;25;0;0.1120059737;0.0049310012
07840;2015/07/04 00:00:00.000;92;87;5;0.2924600423;0.012875392
07848;2015/07/04 00:00:00.000;17;16;1;0.0364463883;0.0016045321
07849;2015/07/04 00:00:00.000;43;48;-5;0.2222340747;0.0097837325
07852;2015/07/04 00:00:00.000;9;10;-1;0.0222234075;0.0009783733
07853;2015/07/04 00:00:00.000;45;42;3;0.2017885398;0.0088836292
07860;2015/07/04 00:00:00.000;107;99;8;0.1511191708;0.0066529381
07863;2015/07/04 00:00:00.000;17;15;2;0.0222234075;0.0009783733
07871;2015/07/04 00:00:00.000;132;143;-11;0.4809145377;0.0211719972
07876;2015/07/04 00:00:00.000;19;21;-2;0.0586697957;0.0025829054
07885;2015/07/04 00:00:00.000;20;20;0;0.0364463883;0.0016045321
07921;2015/07/04 00:00:00.000;32;29;3;0.1075612922;0.0047353266
07922;2015/07/04 00:00:00.000;39;40;-1;0.1528970434;0.006731208
07930;2015/07/04 00:00:00.000;41;48;-7;0.1448966167;0.0063789936
07931;2015/07/04 00:00:00.000;10;11;-1;0.0817821395;0.0036004136
07935;2015/07/04 00:00:00.000;1;1;0;0.0044446815;0.0001956747
07936;2015/07/04 00:00:00.000;39;40;-1;0.1733425783;0.0076313114
07940;2015/07/04 00:00:00.000;31;27;4;0.2533468452;0.0111534551
07945;2015/07/04 00:00:00.000;43;41;2;0.2480132274;0.0109186455
07974;2015/07/04 00:00:00.000;39;43;-4;0.2400128007;0.0105664312
07976;2015/07/04 00:00:00.000;1;1;0;0.035557452;0.0015653972
07980;2015/07/04 00:00:00.000;7;7;0;0.0106672356;0.0004696192
08001;2015/07/04 00:00:00.000;3;3;0;0.0097782993;0.0004304842
08004;2015/07/04 00:00:00.000;34;37;-3;0.0675591587;0.0029742547
08005;2015/07/04 00:00:00.000;217;227;-10;0.2337902466;0.0102924866
08009;2015/07/04 00:00:00.000;58;60;-2;0.1208953366;0.0053223505
08010;2015/07/04 00:00:00.000;76;70;6;0.0728927765;0.0032090643
08014;2015/07/04 00:00:00.000;1;1;0;0.0017778726;0.0000782699
08015;2015/07/04 00:00:00.000;57;57;0;0.1066723559;0.0046961916
08020;2015/07/04 00:00:00.000;3;2;1;0.0160008534;0.0007044287
08021;2015/07/04 00:00:00.000;796;756;40;0.2675698259;0.011779614
08026;2015/07/04 00:00:00.000;6;5;1;0.0080004267;0.0003522144
08027;2015/07/04 00:00:00.000;14;13;1;0.0257791527;0.001134913
08031;2015/07/04 00:00:00.000;30;27;3;0.0604476683;0.0026611753
08035;2015/07/04 00:00:00.000;36;37;-1;0.068448095;0.0030133896
08036;2015/07/04 00:00:00.000;15;13;2;0.0213344712;0.0009392383
08041;2015/07/04 00:00:00.000;3;3;0;0.0231123438;0.0010175082
08048;2015/07/04 00:00:00.000;40;34;6;0.0604476683;0.0026611753
08049;2015/07/04 00:00:00.000;14;16;-2;0.0320017068;0.0014088575
08052;2015/07/04 00:00:00.000;62;67;-5;0.1120059737;0.0049310012
08053;2015/07/04 00:00:00.000;153;151;2;0.4382455953;0.0192935206
08056;2015/07/04 00:00:00.000;16;15;1;0.0275570253;0.0012131828
08057;2015/07/04 00:00:00.000;105;92;13;0.3680196277;0.0162018611
08061;2015/07/04 00:00:00.000;11;9;2;0.0168897897;0.0007435637
08062;2015/07/04 00:00:00.000;56;54;2;0.1742315146;0.0076704463
08066;2015/07/04 00:00:00.000;30;26;4;0.035557452;0.0015653972
08067;2015/07/04 00:00:00.000;6;6;0;0.0168897897;0.0007435637
08070;2015/07/04 00:00:00.000;56;60;-4;0.077337458;0.0034047389
08071;2015/07/04 00:00:00.000;32;34;-2;0.0995608655;0.0043831122
08077;2015/07/04 00:00:00.000;180;166;14;0.2204562021;0.0097054627
08081;2015/07/04 00:00:00.000;175;164;11;0.5155830533;0.0226982595
08083;2015/07/04 00:00:00.000;33;28;5;0.0435578786;0.0019176116
08085;2015/07/04 00:00:00.000;180;176;4;0.1671200242;0.0073573669
08086;2015/07/04 00:00:00.000;31;31;0;0.0453357512;0.0019958814
08089;2015/07/04 00:00:00.000;15;16;-1;0.0133340445;0.000587024
08090;2015/07/04 00:00:00.000;19;18;1;0.0631144772;0.00277858
08094;2015/07/04 00:00:00.000;129;129;0;0.3902430352;0.0171802344
08098;2015/07/04 00:00:00.000;110;118;-8;0.068448095;0.0030133896
08102;2015/07/04 00:00:00.000;6;6;0;0.0097782993;0.0004304842
08103;2015/07/04 00:00:00.000;23;21;2;0.0480025601;0.0021132862
08106;2015/07/04 00:00:00.000;26;24;2;0.0844489484;0.0037178184
08107;2015/07/04 00:00:00.000;202;224;-22;0.1253400181;0.0055180252
08110;2015/07/04 00:00:00.000;48;43;5;0.0897825662;0.0039526279
08201;2015/07/04 00:00:00.000;32;35;-3;0.0577808594;0.0025437705
08205;2015/07/04 00:00:00.000;98;94;4;0.2631251445;0.0115839393
08210;2015/07/04 00:00:00.000;104;102;2;0.2213451384;0.0097445976
08225;2015/07/04 00:00:00.000;30;32;-2;0.1653421516;0.007279097
08230;2015/07/04 00:00:00.000;27;26;1;0.0568919231;0.0025046355
08241;2015/07/04 00:00:00.000;1;1;0;0.008889363;0.0003913493
08244;2015/07/04 00:00:00.000;43;44;-1;0.1911213042;0.00841401
08248;2015/07/04 00:00:00.000;8;10;-2;0.0408910697;0.0018002068
08260;2015/07/04 00:00:00.000;1204;1006;198;1.3885184988;0.061128761
08270;2015/07/04 00:00:00.000;17;17;0;0.0426689423;0.0018784766
08311;2015/07/04 00:00:00.000;12;12;0;0.0062225541;0.0002739445
08312;2015/07/04 00:00:00.000;18;15;3;0.0497804327;0.0021915561
08321;2015/07/04 00:00:00.000;1;1;0;0.0097782993;0.0004304842
08326;2015/07/04 00:00:00.000;3;5;-2;0.0026668089;0.0001174048
08327;2015/07/04 00:00:00.000;2;2;0;0.0071114904;0.0003130794
08328;2015/07/04 00:00:00.000;3;4;-1;0.0035557452;0.0001565397
08341;2015/07/04 00:00:00.000;1;1;0;0.0008690816;0.0000388935
08346;2015/07/04 00:00:00.000;3;3;0;0.0097782993;0.0004304842
08353;2015/07/04 00:00:00.000;3;3;0;0.0017778726;0.0000782699
08402;2015/07/04 00:00:00.000;103;110;-7;0.2880153608;0.0126797174
08403;2015/07/04 00:00:00.000;26;25;1;0.0613366046;0.0027003102
08406;2015/07/04 00:00:00.000;98;97;1;0.2364570555;0.0104098914
08505;2015/07/04 00:00:00.000;55;58;-3;0.1973438583;0.0086879545
08514;2015/07/04 00:00:00.000;19;19;0;0.0497804327;0.0021915561
08515;2015/07/04 00:00:00.000;21;28;-7;0.0720038402;0.0031699293
08525;2015/07/04 00:00:00.000;15;18;-3;0.059558732;0.0026220403
08533;2015/07/04 00:00:00.000;20;21;-1;0.0631144772;0.00277858
08534;2015/07/04 00:00:00.000;63;63;0;0.196454922;0.0086488196
08542;2015/07/04 00:00:00.000;10;9;1;0.0364463883;0.0016045321
08550;2015/07/04 00:00:00.000;61;59;2;0.2346791829;0.0103316216
08553;2015/07/04 00:00:00.000;2;2;0;0.0044446815;0.0001956747
08554;2015/07/04 00:00:00.000;15;11;4;0.0186676623;0.0008218335
08562;2015/07/04 00:00:00.000;10;10;0;0.0311127705;0.0013697226
08608;2015/07/04 00:00:00.000;5;4;1;0.0044446815;0.0001956747
08609;2015/07/04 00:00:00.000;17;16;1;0.0400021334;0.0017610719
08611;2015/07/04 00:00:00.000;52;55;-3;0.0888936299;0.003913493
08618;2015/07/04 00:00:00.000;206;236;-30;0.2284566288;0.0100576771
08620;2015/07/04 00:00:00.000;48;56;-8;0.0533361779;0.0023480958
08701;2015/07/04 00:00:00.000;177;171;6;0.2657919533;0.0117013441
08722;2015/07/04 00:00:00.000;35;35;0;0.0311127705;0.0013697226
08723;2015/07/04 00:00:00.000;178;173;5;0.3617970736;0.0159279166
08731;2015/07/04 00:00:00.000;127;126;1;0.2337902466;0.0102924866
08732;2015/07/04 00:00:00.000;13;13;0;0.0204455349;0.0009001034
08735;2015/07/04 00:00:00.000;58;58;0;0.2773481252;0.0122100982
08736;2015/07/04 00:00:00.000;59;54;5;0.2560136541;0.0112708599
08741;2015/07/04 00:00:00.000;12;12;0;0.0151119171;0.0006652938
08742;2015/07/04 00:00:00.000;642;686;-44;0.377797927;0.0166323453
08751;2015/07/04 00:00:00.000;95;83;12;0.1315625722;0.0057919697
08752;2015/07/04 00:00:00.000;40;44;-4;0.2604583356;0.0114665345
08757;2015/07/04 00:00:00.000;275;251;24;0.4302451686;0.0189413062
08802;2015/07/04 00:00:00.000;16;14;2;0.035557452;0.0015653972
08809;2015/07/04 00:00:00.000;15;16;-1;0.0835600121;0.0036786834
08812;2015/07/04 00:00:00.000;138;164;-26;0.1013387381;0.004461382
08816;2015/07/04 00:00:00.000;185;176;9;0.5706971038;0.0251246252
08820;2015/07/04 00:00:00.000;105;104;1;0.6106992373;0.026885697
08825;2015/07/04 00:00:00.000;19;26;-7;0.0631144772;0.00277858
08826;2015/07/04 00:00:00.000;16;14;2;0.0337795794;0.0014871273
08830;2015/07/04 00:00:00.000;27;28;-1;0.1751204509;0.0077095812
08831;2015/07/04 00:00:00.000;349;349;0;0.5111383718;0.0225025849
08835;2015/07/04 00:00:00.000;24;25;-1;0.0995608655;0.0043831122
08840;2015/07/04 00:00:00.000;56;56;0;0.232012374;0.0102142168
08844;2015/07/04 00:00:00.000;76;85;-9;0.3244617491;0.0142842495
08850;2015/07/04 00:00:00.000;20;21;-1;0.0666702224;0.0029351198
08852;2015/07/04 00:00:00.000;57;53;4;0.172453642;0.0075921765
08857;2015/07/04 00:00:00.000;146;143;3;0.6231443455;0.0274335861
08863;2015/07/04 00:00:00.000;30;29;1;0.0880046936;0.0038743581
08865;2015/07/04 00:00:00.000;216;230;-14;0.1333404448;0.0058702395
08869;2015/07/04 00:00:00.000;12;14;-2;0.0648923498;0.0028568499
08873;2015/07/04 00:00:00.000;150;165;-15;0.496915391;0.021876426
08879;2015/07/04 00:00:00.000;67;72;-5;0.1484523619;0.0065355333
08884;2015/07/04 00:00:00.000;29;26;3;0.0666702224;0.0029351198
08889;2015/07/04 00:00:00.000;37;39;-2;0.0968940566;0.0042657074
08901;2015/07/04 00:00:00.000;42;39;3;0.1804540687;0.0079443908
10001;2015/07/04 00:00:00.000;14;14;0;0.1877161037;0.0143625194
10002;2015/07/04 00:00:00.000;6;8;-2;0.1314524214;0.0100576771
10003;2015/07/04 00:00:00.000;33;31;2;0.3585531027;0.0274335861
10004;2015/07/04 00:00:00.000;22;24;-2;0.0951367719;0.007279097
10006;2015/07/04 00:00:00.000;73;57;16;0.0327352333;0.0025046355
10007;2015/07/04 00:00:00.000;20;18;2;0.0956482599;0.0073182319
10010;2015/07/04 00:00:00.000;32;32;0;0.146285574;0.01119259
10011;2015/07/04 00:00:00.000;73;86;-13;0.5293901017;0.0405046528
10013;2015/07/04 00:00:00.000;67;73;-6;0.5058616527;0.038704446
10014;2015/07/04 00:00:00.000;30;40;-10;0.3304212615;0.0252811649
10017;2015/07/04 00:00:00.000;44;49;-5;0.2025492563;0.0154974324
10018;2015/07/04 00:00:00.000;4;5;-1;0.04910285;0.0037569533
10021;2015/07/04 00:00:00.000;33;32;1;0.4567588027;0.0349474927
10022;2015/07/04 00:00:00.000;72;69;3;0.6061133048;0.0463748923
10023;2015/07/04 00:00:00.000;59;61;-2;0.5764469996;0.0441050663
10024;2015/07/04 00:00:00.000;29;37;-8;0.5232522454;0.0400350336
10025;2015/07/04 00:00:00.000;52;60;-8;0.6127626491;0.0468836464
10027;2015/07/04 00:00:00.000;16;15;1;0.2322155615;0.0177672583
10028;2015/07/04 00:00:00.000;34;40;-6;0.4076559527;0.0311905394
10029;2015/07/04 00:00:00.000;31;33;-2;0.1130388526;0.0086488196
10030;2015/07/04 00:00:00.000;7;9;-2;0.1391247417;0.010644701
10031;2015/07/04 00:00:00.000;8;10;-2;0.2255662172;0.0172585042
10032;2015/07/04 00:00:00.000;8;7;1;0.2337500256;0.0178846631
10034;2015/07/04 00:00:00.000;3;2;1;0.1764633672;0.0135015509
10035;2015/07/04 00:00:00.000;3;3;0;0.1130388526;0.0086488196
10036;2015/07/04 00:00:00.000;49;45;4;0.1028090922;0.007866121
10037;2015/07/04 00:00:00.000;1;1;0;0.0281318412;0.0021524212
10038;2015/07/04 00:00:00.000;16;17;-1;0.0797921313;0.0061050491
10039;2015/07/04 00:00:00.000;41;47;-6;0.0792806432;0.0060659142
10040;2015/07/04 00:00:00.000;1;1;0;0.0557521943;0.0042657074
10044;2015/07/04 00:00:00.000;2;2;0;0.0383616016;0.0029351198
10065;2015/07/04 00:00:00.000;63;62;1;0.4506209465;0.0344778735
10069;2015/07/04 00:00:00.000;36;36;0;0.0685393948;0.0052440806
10075;2015/07/04 00:00:00.000;18;24;-6;0.2342615136;0.017923798
10128;2015/07/04 00:00:00.000;39;41;-2;0.4424371381;0.0338517146
10301;2015/07/04 00:00:00.000;20;23;-3;0.1672565829;0.0127971222
10302;2015/07/04 00:00:00.000;9;8;1;0.0956482599;0.0073182319
10303;2015/07/04 00:00:00.000;24;21;3;0.1109929005;0.0084922799
10304;2015/07/04 00:00:00.000;45;36;9;0.3242834053;0.0248115457
10305;2015/07/04 00:00:00.000;22;23;-1;0.2230087771;0.0170628296
10306;2015/07/04 00:00:00.000;65;55;10;0.4966548683;0.0380000172
10307;2015/07/04 00:00:00.000;15;8;7;0.123268613;0.0094315182
10308;2015/07/04 00:00:00.000;28;23;5;0.2143134808;0.0163975358
10312;2015/07/04 00:00:00.000;69;61;8;0.4460175543;0.0341256591
10451;2015/07/04 00:00:00.000;4;4;0;0.0710968349;0.0054397553
10452;2015/07/04 00:00:00.000;2;2;0;0.1646991427;0.0126014475
10455;2015/07/04 00:00:00.000;3;3;0;0.073654275;0.0056354299
10456;2015/07/04 00:00:00.000;23;21;2;0.1186652209;0.0090793038
10458;2015/07/04 00:00:00.000;6;8;-2;0.1115043886;0.0085314148
10459;2015/07/04 00:00:00.000;5;5;0;0.1201996849;0.0091967086
10460;2015/07/04 00:00:00.000;12;13;-1;0.1191767089;0.0091184387
10461;2015/07/04 00:00:00.000;18;18;0;0.340651022;0.0260638635
10464;2015/07/04 00:00:00.000;7;9;-2;0.0664934427;0.0050875409
10465;2015/07/04 00:00:00.000;94;92;2;0.6076477689;0.0464922971
10467;2015/07/04 00:00:00.000;33;28;5;0.2767150193;0.0211719972
10468;2015/07/04 00:00:00.000;6;6;0;0.1728829511;0.0132276064
10470;2015/07/04 00:00:00.000;21;20;1;0.0659819547;0.005048406
10471;2015/07/04 00:00:00.000;59;63;-4;0.2874562678;0.0219938308
10472;2015/07/04 00:00:00.000;2;2;0;0.0690508828;0.0052832156
10473;2015/07/04 00:00:00.000;17;19;-2;0.194876936;0.0149104084
10501;2015/07/04 00:00:00.000;2;3;-1;0.0046033922;0.0003522144
10502;2015/07/04 00:00:00.000;14;14;0;0.04910285;0.0037569533
10504;2015/07/04 00:00:00.000;30;31;-1;0.171348487;0.0131102016
10505;2015/07/04 00:00:00.000;4;3;1;0.000511488;0.0000391349
10506;2015/07/04 00:00:00.000;25;18;7;0.1201996849;0.0091967086
10507;2015/07/04 00:00:00.000;11;9;2;0.0434764818;0.0033264691
10509;2015/07/04 00:00:00.000;56;49;7;0.1539578943;0.011779614
10510;2015/07/04 00:00:00.000;32;37;-5;0.121222661;0.0092749785
10511;2015/07/04 00:00:00.000;7;5;2;0.0086952964;0.0006652938
10512;2015/07/04 00:00:00.000;192;196;-4;0.2705771631;0.0207023781
10514;2015/07/04 00:00:00.000;45;44;1;0.1534464063;0.0117404791
10516;2015/07/04 00:00:00.000;15;14;1;0.1416821818;0.0108403757
10518;2015/07/04 00:00:00.000;5;4;1;0.0112527365;0.0008609685
10522;2015/07/04 00:00:00.000;19;22;-3;0.1831127115;0.014010305
10524;2015/07/04 00:00:00.000;21;17;4;0.1074124844;0.0082183353
10526;2015/07/04 00:00:00.000;9;12;-3;0.0194365448;0.0014871273
10530;2015/07/04 00:00:00.000;22;22;0;0.2035722323;0.0155757022
10532;2015/07/04 00:00:00.000;13;13;0;0.0230169609;0.0017610719
10535;2015/07/04 00:00:00.000;4;4;0;0.0025574401;0.0001956747
10536;2015/07/04 00:00:00.000;35;35;0;0.1416821818;0.0108403757
10541;2015/07/04 00:00:00.000;83;89;-6;0.3698058391;0.0282945545
10546;2015/07/04 00:00:00.000;5;5;0;0.0219939849;0.001682802
10549;2015/07/04 00:00:00.000;41;50;-9;0.1340098615;0.0102533517
10550;2015/07/04 00:00:00.000;19;16;3;0.1994803282;0.0152626228
10553;2015/07/04 00:00:00.000;13;10;3;0.1181537328;0.0090401689
10562;2015/07/04 00:00:00.000;69;68;1;0.2490946662;0.019058711
10566;2015/07/04 00:00:00.000;38;44;-6;0.1375902776;0.0105272962
10570;2015/07/04 00:00:00.000;32;34;-2;0.1493545021;0.0114273996
10576;2015/07/04 00:00:00.000;36;36;0;0.0833725474;0.0063789936
10577;2015/07/04 00:00:00.000;12;13;-1;0.0531947542;0.0040700327
10578;2015/07/04 00:00:00.000;1;1;0;0.0112527365;0.0008609685
10579;2015/07/04 00:00:00.000;42;45;-3;0.1048550443;0.0080226607
10580;2015/07/04 00:00:00.000;60;59;1;0.2598359146;0.0198805445
10588;2015/07/04 00:00:00.000;11;7;4;0.0102297604;0.0007826986
10589;2015/07/04 00:00:00.000;44;41;3;0.0803036193;0.006144184
10594;2015/07/04 00:00:00.000;14;14;0;0.0373386255;0.0028568499
10596;2015/07/04 00:00:00.000;4;4;0;0.0138101766;0.0010566431
10597;2015/07/04 00:00:00.000;6;4;2;0.0153446406;0.0011740479
10601;2015/07/04 00:00:00.000;17;15;2;0.0956482599;0.0073182319
10605;2015/07/04 00:00:00.000;49;50;-1;0.2746690673;0.0210154575
10606;2015/07/04 00:00:00.000;19;19;0;0.1002516521;0.0076704463
10703;2015/07/04 00:00:00.000;17;20;-3;0.1723714631;0.0131884715
10704;2015/07/04 00:00:00.000;26;32;-6;0.3043353725;0.0232852835
10705;2015/07/04 00:00:00.000;23;18;5;0.3084272766;0.0235983629
10707;2015/07/04 00:00:00.000;28;30;-2;0.1299179573;0.0099402723
10708;2015/07/04 00:00:00.000;87;92;-5;0.5334820059;0.0408177322
10709;2015/07/04 00:00:00.000;23;22;1;0.1340098615;0.0102533517
10801;2015/07/04 00:00:00.000;24;25;-1;0.3058698365;0.0234026883
10804;2015/07/04 00:00:00.000;51;56;-5;0.2148249688;0.0164366707
10805;2015/07/04 00:00:00.000;13;11;2;0.2337500256;0.0178846631
10913;2015/07/04 00:00:00.000;8;8;0;0.0127872005;0.0009783733
10917;2015/07/04 00:00:00.000;13;14;-1;0.0158561286;0.0012131828
10918;2015/07/04 00:00:00.000;39;45;-6;0.0537062422;0.0041091677
10920;2015/07/04 00:00:00.000;18;21;-3;0.024551425;0.0018784766
10921;2015/07/04 00:00:00.000;10;8;2;0.0281318412;0.0021524212
10923;2015/07/04 00:00:00.000;25;21;4;0.0296663052;0.002269826
10927;2015/07/04 00:00:00.000;20;18;2;0.0383616016;0.0029351198
10928;2015/07/04 00:00:00.000;13;12;1;0.0209710089;0.0016045321
10933;2015/07/04 00:00:00.000;2;2;0;0.0004952726;0.0000388935
10950;2015/07/04 00:00:00.000;97;95;2;0.317634061;0.0243027917
10954;2015/07/04 00:00:00.000;202;196;6;0.1646991427;0.0126014475
10956;2015/07/04 00:00:00.000;97;101;-4;0.2383534178;0.0182368775
10958;2015/07/04 00:00:00.000;15;18;-3;0.0194365448;0.0014871273
10960;2015/07/04 00:00:00.000;41;40;1;0.1795322954;0.0137363605
10965;2015/07/04 00:00:00.000;33;33;0;0.097694212;0.0074747717
10968;2015/07/04 00:00:00.000;15;16;-1;0.0572866583;0.0043831122
10970;2015/07/04 00:00:00.000;51;44;7;0.0864414755;0.0066138032
10973;2015/07/04 00:00:00.000;12;12;0;0.0051148802;0.0003913493
10976;2015/07/04 00:00:00.000;1;1;0;0.0066493443;0.0005087541
10977;2015/07/04 00:00:00.000;164;176;-12;0.1166192688;0.0089227641
10983;2015/07/04 00:00:00.000;19;19;0;0.0511488021;0.003913493
10986;2015/07/04 00:00:00.000;8;7;1;0.0199480328;0.0015262623
10987;2015/07/04 00:00:00.000;28;25;3;0.0588211224;0.004500517
10990;2015/07/04 00:00:00.000;82;75;7;0.2306810974;0.0176498535
10992;2015/07/04 00:00:00.000;44;42;2;0.0849070115;0.0064963984
10994;2015/07/04 00:00:00.000;17;16;1;0.0388730896;0.0029742547
11001;2015/07/04 00:00:00.000;130;134;-4;0.1979458641;0.015145218
11003;2015/07/04 00:00:00.000;54;50;4;0.1769748552;0.0135406858
11004;2015/07/04 00:00:00.000;9;11;-2;0.048079874;0.0036786834
11010;2015/07/04 00:00:00.000;23;22;1;0.1580497985;0.0120926934
11020;2015/07/04 00:00:00.000;46;54;-8;0.0562636823;0.0043048423
11023;2015/07/04 00:00:00.000;27;32;-5;0.0905333797;0.0069268826
11030;2015/07/04 00:00:00.000;45;53;-8;0.1907850318;0.014597329
11096;2015/07/04 00:00:00.000;3;4;-1;0.0184135688;0.0014088575
11103;2015/07/04 00:00:00.000;8;10;-2;0.04910285;0.0037569533
11104;2015/07/04 00:00:00.000;16;24;-8;0.1774863433;0.0135798208
11106;2015/07/04 00:00:00.000;14;10;4;0.0997401641;0.0076313114
11109;2015/07/04 00:00:00.000;11;9;2;0.073142787;0.005596295
11203;2015/07/04 00:00:00.000;21;16;5;0.464431123;0.0355345166
11206;2015/07/04 00:00:00.000;12;10;2;0.1319639094;0.010096812
11207;2015/07/04 00:00:00.000;30;23;7;0.3861734558;0.0295468723
11211;2015/07/04 00:00:00.000;51;55;-4;0.2511406183;0.0192152507
11212;2015/07/04 00:00:00.000;11;11;0;0.1442396219;0.0110360503
11216;2015/07/04 00:00:00.000;28;27;1;0.2777379954;0.0212502671
11217;2015/07/04 00:00:00.000;22;25;-3;0.2342615136;0.017923798
11220;2015/07/04 00:00:00.000;11;8;3;0.2051066964;0.015693107
11221;2015/07/04 00:00:00.000;44;31;13;0.3723632793;0.0284902292
11224;2015/07/04 00:00:00.000;26;34;-8;0.121222661;0.0092749785
11225;2015/07/04 00:00:00.000;12;11;1;0.1437281339;0.0109969154
11230;2015/07/04 00:00:00.000;23;22;1;0.3534382225;0.0270422368
11231;2015/07/04 00:00:00.000;14;15;-1;0.1611187266;0.012327503
11234;2015/07/04 00:00:00.000;142;149;-7;0.9324426622;0.0713429777
11235;2015/07/04 00:00:00.000;131;129;2;0.6654459153;0.0509145442
11236;2015/07/04 00:00:00.000;50;53;-3;0.4787527876;0.0366302947
11237;2015/07/04 00:00:00.000;11;12;-1;0.0992286761;0.0075921765
11238;2015/07/04 00:00:00.000;39;33;6;0.2767150193;0.0211719972
11243;2015/07/04 00:00:00.000;1;1;0;0.0035804161;0.0002739445
11249;2015/07/04 00:00:00.000;27;26;1;0.0864414755;0.0066138032
11354;2015/07/04 00:00:00.000;70;54;16;0.1534464063;0.0117404791
11355;2015/07/04 00:00:00.000;37;41;-4;0.0961597479;0.0073573669
11358;2015/07/04 00:00:00.000;26;26;0;0.1191767089;0.0091184387
11363;2015/07/04 00:00:00.000;60;63;-3;0.0603555865;0.0046179218
11364;2015/07/04 00:00:00.000;33;31;2;0.122245637;0.0093532483
11366;2015/07/04 00:00:00.000;14;12;2;0.0557521943;0.0042657074
11367;2015/07/04 00:00:00.000;18;19;-1;0.1201996849;0.0091967086
11372;2015/07/04 00:00:00.000;13;11;2;0.2823413876;0.0216024815
11377;2015/07/04 00:00:00.000;11;13;-2;0.3196800131;0.0244593314
11378;2015/07/04 00:00:00.000;17;15;2;0.2373304417;0.0181586076
11411;2015/07/04 00:00:00.000;132;116;16;0.1150848047;0.0088053593
11414;2015/07/04 00:00:00.000;42;43;-1;0.2214743131;0.0169454248
11415;2015/07/04 00:00:00.000;19;19;0;0.1846471756;0.0141277098
11419;2015/07/04 00:00:00.000;124;128;-4;0.072631299;0.0055571601
11420;2015/07/04 00:00:00.000;30;27;3;0.1800437834;0.0137754954
11429;2015/07/04 00:00:00.000;102;104;-2;0.098717188;0.0075530415
11435;2015/07/04 00:00:00.000;28;36;-8;0.2020377683;0.0154582974
11436;2015/07/04 00:00:00.000;64;57;7;0.0567751703;0.0043439773
11509;2015/07/04 00:00:00.000;22;24;-2;0.0214824969;0.0016436671
11510;2015/07/04 00:00:00.000;316;318;-2;0.1442396219;0.0110360503
11520;2015/07/04 00:00:00.000;85;99;-14;0.1887390797;0.0144407892
11530;2015/07/04 00:00:00.000;77;85;-8;0.341673998;0.0261421334
11542;2015/07/04 00:00:00.000;49;46;3;0.1611187266;0.012327503
11550;2015/07/04 00:00:00.000;71;70;1;0.1836241995;0.0140494399
11554;2015/07/04 00:00:00.000;52;63;-11;0.1733944391;0.0132667413
11557;2015/07/04 00:00:00.000;29;30;-1;0.0905333797;0.0069268826
11558;2015/07/04 00:00:00.000;18;20;-2;0.0434764818;0.0033264691
11561;2015/07/04 00:00:00.000;651;756;-105;0.4792642756;0.0366694296
11563;2015/07/04 00:00:00.000;34;34;0;0.1851586636;0.0141668447
11565;2015/07/04 00:00:00.000;26;21;5;0.072631299;0.0055571601
11570;2015/07/04 00:00:00.000;67;70;-3;0.2956400761;0.0226199897
11577;2015/07/04 00:00:00.000;47;46;1;0.1007631401;0.0077095812
11579;2015/07/04 00:00:00.000;20;20;0;0.0501258261;0.0038352232
11581;2015/07/04 00:00:00.000;43;45;-2;0.2178938969;0.0166714803
11598;2015/07/04 00:00:00.000;33;39;-6;0.1140618287;0.0087270894
11692;2015/07/04 00:00:00.000;5;4;1;0.0557521943;0.0042657074
11693;2015/07/04 00:00:00.000;60;81;-21;0.0414305297;0.0031699293
11701;2015/07/04 00:00:00.000;132;120;12;0.0930908198;0.0071225573
11703;2015/07/04 00:00:00.000;30;30;0;0.0618900505;0.0047353266
11704;2015/07/04 00:00:00.000;70;71;-1;0.0823495714;0.0063007238
11706;2015/07/04 00:00:00.000;94;92;2;0.1815782474;0.0138929002
11713;2015/07/04 00:00:00.000;14;13;1;0.0378501136;0.0028959848
11714;2015/07/04 00:00:00.000;27;30;-3;0.1007631401;0.0077095812
11717;2015/07/04 00:00:00.000;51;54;-3;0.0659819547;0.005048406
11718;2015/07/04 00:00:00.000;17;18;-1;0.0337582094;0.0025829054
11722;2015/07/04 00:00:00.000;54;60;-6;0.0905333797;0.0069268826
11724;2015/07/04 00:00:00.000;15;11;4;0.0639360026;0.0048918663
11726;2015/07/04 00:00:00.000;35;42;-7;0.0603555865;0.0046179218
11727;2015/07/04 00:00:00.000;84;75;9;0.0982057;0.0075139066
11731;2015/07/04 00:00:00.000;46;48;-2;0.0900218917;0.0068877477
11732;2015/07/04 00:00:00.000;7;7;0;0.0230169609;0.0017610719
11735;2015/07/04 00:00:00.000;38;35;3;0.1432166459;0.0109577805
11740;2015/07/04 00:00:00.000;17;22;-5;0.0455224339;0.0034830088
11741;2015/07/04 00:00:00.000;44;49;-5;0.0818380834;0.0062615888
11746;2015/07/04 00:00:00.000;750;766;-16;0.3529267345;0.0270031018
11751;2015/07/04 00:00:00.000;35;40;-5;0.0531947542;0.0040700327
11755;2015/07/04 00:00:00.000;25;26;-1;0.0301777932;0.0023089609
11756;2015/07/04 00:00:00.000;70;91;-21;0.1820897355;0.0139320351
11762;2015/07/04 00:00:00.000;37;41;-4;0.0900218917;0.0068877477
11766;2015/07/04 00:00:00.000;57;53;4;0.0588211224;0.004500517
11767;2015/07/04 00:00:00.000;49;49;0;0.0542177302;0.0041483026
11770;2015/07/04 00:00:00.000;1;2;-1;0.0112527365;0.0008609685
11771;2015/07/04 00:00:00.000;37;38;-1;0.0705853469;0.0054006204
11779;2015/07/04 00:00:00.000;140;160;-20;0.1340098615;0.0102533517
11780;2015/07/04 00:00:00.000;62;61;1;0.0936023078;0.0071616922
11784;2015/07/04 00:00:00.000;48;53;-5;0.1033205802;0.0079052559
11786;2015/07/04 00:00:00.000;23;21;2;0.0286433292;0.0021915561
11787;2015/07/04 00:00:00.000;98;102;-4;0.1964114;0.0150278132
11788;2015/07/04 00:00:00.000;42;40;2;0.072631299;0.0055571601
11792;2015/07/04 00:00:00.000;40;41;-1;0.0925793318;0.0070834224
11793;2015/07/04 00:00:00.000;71;72;-1;0.1258260532;0.0096271928
11796;2015/07/04 00:00:00.000;8;8;0;0.0040919042;0.0003130794
11797;2015/07/04 00:00:00.000;36;34;2;0.0910448677;0.0069660176
11803;2015/07/04 00:00:00.000;78;78;0;0.1396362297;0.0106838359
11804;2015/07/04 00:00:00.000;14;9;5;0.0199480328;0.0015262623
11901;2015/07/04 00:00:00.000;190;176;14;0.1150848047;0.0088053593
11932;2015/07/04 00:00:00.000;8;7;1;0.0797921313;0.0061050491
11933;2015/07/04 00:00:00.000;118;104;14;0.0803036193;0.006144184
11937;2015/07/04 00:00:00.000;198;193;5;0.5339934939;0.0408568671
11939;2015/07/04 00:00:00.000;5;6;-1;0.0148331526;0.001134913
11944;2015/07/04 00:00:00.000;21;22;-1;0.0895104037;0.0068486128
11946;2015/07/04 00:00:00.000;53;56;-3;0.1248030771;0.009548923
11949;2015/07/04 00:00:00.000;34;35;-1;0.074165763;0.0056745649
11950;2015/07/04 00:00:00.000;52;47;5;0.0265973771;0.0020350164
11953;2015/07/04 00:00:00.000;59;61;-2;0.0613785625;0.0046961916
11954;2015/07/04 00:00:00.000;57;49;8;0.24295681;0.0185890918
11957;2015/07/04 00:00:00.000;6;6;0;0.025574401;0.0019567465
11958;2015/07/04 00:00:00.000;4;5;-1;0.0138101766;0.0010566431
11963;2015/07/04 00:00:00.000;73;64;9;0.1805552714;0.0138146304
11967;2015/07/04 00:00:00.000;102;89;13;0.0956482599;0.0073182319
11968;2015/07/04 00:00:00.000;111;109;2;0.3068928126;0.0234809581
11971;2015/07/04 00:00:00.000;43;45;-2;0.1907850318;0.014597329
11975;2015/07/04 00:00:00.000;1;1;0;0.0204595208;0.0015653972
11976;2015/07/04 00:00:00.000;35;42;-7;0.0941137959;0.0072008272
11980;2015/07/04 00:00:00.000;22;19;3;0.024551425;0.0018784766
12015;2015/07/04 00:00:00.000;25;24;1;0.0828610594;0.0063398587
12018;2015/07/04 00:00:00.000;27;24;3;0.0511488021;0.003913493
12019;2015/07/04 00:00:00.000;39;32;7;0.0803036193;0.006144184
12023;2015/07/04 00:00:00.000;9;8;1;0.0107412484;0.0008218335
12027;2015/07/04 00:00:00.000;5;7;-2;0.0225054729;0.0017219369
12028;2015/07/04 00:00:00.000;1;1;0;0.0051148802;0.0003913493
12032;2015/07/04 00:00:00.000;8;6;2;0.0173905927;0.0013305876
12036;2015/07/04 00:00:00.000;1;1;0;0.0009320663;0.0000734062
12037;2015/07/04 00:00:00.000;6;6;0;0.0680279068;0.0052049457
12041;2015/07/04 00:00:00.000;1;1;0;0.0030689281;0.0002348096
12042;2015/07/04 00:00:00.000;1;1;0;0.0056263682;0.0004304842
12047;2015/07/04 00:00:00.000;31;38;-7;0.0700738589;0.0053614854
12053;2015/07/04 00:00:00.000;10;9;1;0.0260858891;0.0019958814
12054;2015/07/04 00:00:00.000;30;33;-3;0.1002516521;0.0076704463
12058;2015/07/04 00:00:00.000;3;3;0;0.0020459521;0.0001565397
12059;2015/07/04 00:00:00.000;5;5;0;0.0127872005;0.0009783733
12060;2015/07/04 00:00:00.000;5;4;1;0.0117642245;0.0009001034
12061;2015/07/04 00:00:00.000;16;16;0;0.0567751703;0.0043439773
12064;2015/07/04 00:00:00.000;2;2;0;0.001022976;0.0000782699
12065;2015/07/04 00:00:00.000;280;296;-16;0.2762035313;0.0211328623
12067;2015/07/04 00:00:00.000;6;4;2;0.0056263682;0.0004304842
12068;2015/07/04 00:00:00.000;3;4;-1;0.0117642245;0.0009001034
12072;2015/07/04 00:00:00.000;5;2;3;0.0071608323;0.000547889
12075;2015/07/04 00:00:00.000;14;10;4;0.0179020807;0.0013697226
12076;2015/07/04 00:00:00.000;11;9;2;0.0317122573;0.0024263657
12078;2015/07/04 00:00:00.000;59;61;-2;0.121734149;0.0093141134
12086;2015/07/04 00:00:00.000;1;1;0;0.0020459521;0.0001565397
12093;2015/07/04 00:00:00.000;8;8;0;0.0107412484;0.0008218335
12094;2015/07/04 00:00:00.000;6;8;-2;0.0051148802;0.0003913493
12108;2015/07/04 00:00:00.000;5;5;0;0.0040919042;0.0003130794
12110;2015/07/04 00:00:00.000;37;35;2;0.0946252839;0.0072399621
12116;2015/07/04 00:00:00.000;7;8;-1;0.0081838083;0.0006261589
12121;2015/07/04 00:00:00.000;4;3;1;0.0081838083;0.0006261589
12122;2015/07/04 00:00:00.000;10;11;-1;0.0260858891;0.0019958814
12125;2015/07/04 00:00:00.000;3;3;0;0.0209710089;0.0016045321
12134;2015/07/04 00:00:00.000;13;16;-3;0.0424535057;0.0032481992
12137;2015/07/04 00:00:00.000;6;5;1;0.0138101766;0.0010566431
12138;2015/07/04 00:00:00.000;5;7;-2;0.0102297604;0.0007826986
12144;2015/07/04 00:00:00.000;40;39;1;0.0946252839;0.0072399621
12147;2015/07/04 00:00:00.000;3;3;0;0.0056263682;0.0004304842
12150;2015/07/04 00:00:00.000;6;4;2;0.000511488;0.0000391349
12151;2015/07/04 00:00:00.000;2;4;-2;0.025574401;0.0019567465
12156;2015/07/04 00:00:00.000;3;3;0;0.0025574401;0.0001956747
12157;2015/07/04 00:00:00.000;10;12;-2;0.0194365448;0.0014871273
12166;2015/07/04 00:00:00.000;2;2;0;0.0015344641;0.0001174048
12167;2015/07/04 00:00:00.000;9;12;-3;0.0148331526;0.001134913
12170;2015/07/04 00:00:00.000;21;21;0;0.0363156495;0.00277858
12182;2015/07/04 00:00:00.000;26;24;2;0.0629130266;0.0048135964
12187;2015/07/04 00:00:00.000;1;1;0;0.0035804161;0.0002739445
12188;2015/07/04 00:00:00.000;18;19;-1;0.0593326104;0.0045396519
12192;2015/07/04 00:00:00.000;4;5;-1;0.0025574401;0.0001956747
12193;2015/07/04 00:00:00.000;10;9;1;0.0040919042;0.0003130794
12197;2015/07/04 00:00:00.000;11;10;1;0.0092067844;0.0007044287
12198;2015/07/04 00:00:00.000;16;18;-2;0.0347811854;0.0026611753
12203;2015/07/04 00:00:00.000;54;55;-1;0.1682795589;0.012875392
12204;2015/07/04 00:00:00.000;19;24;-5;0.0194365448;0.0014871273
12208;2015/07/04 00:00:00.000;59;56;3;0.1329868854;0.0101750819
12209;2015/07/04 00:00:00.000;26;27;-1;0.0639360026;0.0048918663
12302;2015/07/04 00:00:00.000;372;340;32;0.1933424719;0.0147930036
12303;2015/07/04 00:00:00.000;74;73;1;0.0864414755;0.0066138032
12305;2015/07/04 00:00:00.000;3;3;0;0.0153446406;0.0011740479
12306;2015/07/04 00:00:00.000;176;174;2;0.146797062;0.011231725
12309;2015/07/04 00:00:00.000;418;472;-54;0.1749289032;0.0133841461
12404;2015/07/04 00:00:00.000;12;19;-7;0.0577981464;0.0044222471
12405;2015/07/04 00:00:00.000;1;2;-1;0.0015344641;0.0001174048
12409;2015/07/04 00:00:00.000;14;16;-2;0.0312007693;0.0023872307
12413;2015/07/04 00:00:00.000;13;12;1;0.0547292182;0.0041874375
12418;2015/07/04 00:00:00.000;4;4;0;0.0015344641;0.0001174048
12421;2015/07/04 00:00:00.000;2;2;0;0.0025574401;0.0001956747
12422;2015/07/04 00:00:00.000;2;4;-2;0.0071608323;0.000547889
12428;2015/07/04 00:00:00.000;13;18;-5;0.0501258261;0.0038352232
12433;2015/07/04 00:00:00.000;1;1;0;0.0051148802;0.0003913493
12434;2015/07/04 00:00:00.000;3;2;1;0.0035804161;0.0002739445
12438;2015/07/04 00:00:00.000;1;1;0;0.0086952964;0.0006652938
12439;2015/07/04 00:00:00.000;1;1;0;0.000511488;0.0000391349
12443;2015/07/04 00:00:00.000;13;15;-2;0.0199480328;0.0015262623
12444;2015/07/04 00:00:00.000;5;11;-6;0.0122757125;0.0009392383
12450;2015/07/04 00:00:00.000;1;1;0;0.0035804161;0.0002739445
12451;2015/07/04 00:00:00.000;2;2;0;0.0046033922;0.0003522144
12460;2015/07/04 00:00:00.000;1;1;0;0.000511488;0.0000391349
12464;2015/07/04 00:00:00.000;2;3;-1;0.0337582094;0.0025829054
12468;2015/07/04 00:00:00.000;7;11;-4;0.023528449;0.0018002068
12469;2015/07/04 00:00:00.000;5;5;0;0.0127872005;0.0009783733
12472;2015/07/04 00:00:00.000;4;3;1;0.025062913;0.0019176116
12473;2015/07/04 00:00:00.000;5;4;1;0.0112527365;0.0008609685
12477;2015/07/04 00:00:00.000;54;72;-18;0.1693025349;0.0129536619
12480;2015/07/04 00:00:00.000;1;1;0;0.0148331526;0.001134913
12484;2015/07/04 00:00:00.000;8;12;-4;0.04910285;0.0037569533
12494;2015/07/04 00:00:00.000;4;5;-1;0.0097182724;0.0007435637
12501;2015/07/04 00:00:00.000;7;6;1;0.0204595208;0.0015653972
12502;2015/07/04 00:00:00.000;6;6;0;0.0117642245;0.0009001034
12507;2015/07/04 00:00:00.000;1;1;0;0.0015344641;0.0001174048
12516;2015/07/04 00:00:00.000;6;3;3;0.0102297604;0.0007826986
12521;2015/07/04 00:00:00.000;7;7;0;0.0107412484;0.0008218335
12522;2015/07/04 00:00:00.000;24;21;3;0.0179020807;0.0013697226
12525;2015/07/04 00:00:00.000;8;9;-1;0.024039937;0.0018393417
12526;2015/07/04 00:00:00.000;12;12;0;0.0209710089;0.0016045321
12528;2015/07/04 00:00:00.000;62;65;-3;0.0874644516;0.0066920731
12529;2015/07/04 00:00:00.000;14;13;1;0.0271088651;0.0020741513
12533;2015/07/04 00:00:00.000;102;98;4;0.1810667594;0.0138537653
12534;2015/07/04 00:00:00.000;35;39;-4;0.1882275917;0.0144016543
12540;2015/07/04 00:00:00.000;28;25;3;0.0680279068;0.0052049457
12543;2015/07/04 00:00:00.000;6;6;0;0.0061378563;0.0004696192
12546;2015/07/04 00:00:00.000;13;14;-1;0.0322237453;0.0024655006
12547;2015/07/04 00:00:00.000;12;12;0;0.0225054729;0.0017219369
12550;2015/07/04 00:00:00.000;144;157;-13;0.4296499376;0.0328733414
12563;2015/07/04 00:00:00.000;27;31;-4;0.0644474906;0.0049310012
12564;2015/07/04 00:00:00.000;31;34;-3;0.1028090922;0.007866121
12566;2015/07/04 00:00:00.000;47;44;3;0.0710968349;0.0054397553
12567;2015/07/04 00:00:00.000;19;17;2;0.0281318412;0.0021524212
12569;2015/07/04 00:00:00.000;28;33;-5;0.0552407063;0.0042265725
12570;2015/07/04 00:00:00.000;28;29;-1;0.0383616016;0.0029351198
12575;2015/07/04 00:00:00.000;9;9;0;0.0107412484;0.0008218335
12577;2015/07/04 00:00:00.000;16;17;-1;0.0081838083;0.0006261589
12578;2015/07/04 00:00:00.000;12;10;2;0.0163676167;0.0012523178
12580;2015/07/04 00:00:00.000;14;13;1;0.0219939849;0.001682802
12581;2015/07/04 00:00:00.000;8;8;0;0.0138101766;0.0010566431
12582;2015/07/04 00:00:00.000;21;24;-3;0.0347811854;0.0026611753
12586;2015/07/04 00:00:00.000;34;39;-5;0.0506373141;0.0038743581
12589;2015/07/04 00:00:00.000;45;46;-1;0.0941137959;0.0072008272
12594;2015/07/04 00:00:00.000;6;9;-3;0.0122757125;0.0009392383
12701;2015/07/04 00:00:00.000;33;35;-2;0.1161077808;0.0088836292
12721;2015/07/04 00:00:00.000;28;33;-5;0.0429649938;0.0032873341
12726;2015/07/04 00:00:00.000;6;6;0;0.0092067844;0.0007044287
12734;2015/07/04 00:00:00.000;3;3;0;0.0081838083;0.0006261589
12737;2015/07/04 00:00:00.000;18;19;-1;0.025574401;0.0019567465
12738;2015/07/04 00:00:00.000;2;2;0;0.0015344641;0.0001174048
12740;2015/07/04 00:00:00.000;2;3;-1;0.0112527365;0.0008609685
12743;2015/07/04 00:00:00.000;3;3;0;0.0056263682;0.0004304842
12748;2015/07/04 00:00:00.000;9;8;1;0.0327352333;0.0025046355
12752;2015/07/04 00:00:00.000;2;2;0;0.0025574401;0.0001956747
12759;2015/07/04 00:00:00.000;2;2;0;0.0092067844;0.0007044287
12760;2015/07/04 00:00:00.000;1;1;0;0.0030689281;0.0002348096
12764;2015/07/04 00:00:00.000;13;12;1;0.0854184995;0.0065355333
12765;2015/07/04 00:00:00.000;3;3;0;0.0281318412;0.0021524212
12768;2015/07/04 00:00:00.000;5;6;-1;0.0194365448;0.0014871273
12775;2015/07/04 00:00:00.000;23;24;-1;0.0404075537;0.0030916595
12776;2015/07/04 00:00:00.000;7;6;1;0.0322237453;0.0024655006
12779;2015/07/04 00:00:00.000;5;6;-1;0.0107412484;0.0008218335
12780;2015/07/04 00:00:00.000;10;11;-1;0.0132986885;0.0010175082
12783;2015/07/04 00:00:00.000;12;13;-1;0.0291548172;0.002230691
12786;2015/07/04 00:00:00.000;5;6;-1;0.0460339219;0.0035221437
12790;2015/07/04 00:00:00.000;23;28;-5;0.0792806432;0.0060659142
12804;2015/07/04 00:00:00.000;109;98;11;0.2419338339;0.018510822
12808;2015/07/04 00:00:00.000;1;1;0;0.025574401;0.0019567465
12812;2015/07/04 00:00:00.000;3;2;1;0.0030689281;0.0002348096
12821;2015/07/04 00:00:00.000;2;2;0;0.0004952726;0.0000388935
12822;2015/07/04 00:00:00.000;16;13;3;0.0214824969;0.0016436671
12824;2015/07/04 00:00:00.000;3;5;-2;0.0076723203;0.000587024
12828;2015/07/04 00:00:00.000;16;20;-4;0.0358041615;0.0027394451
12831;2015/07/04 00:00:00.000;220;206;14;0.1135503407;0.0086879545
12834;2015/07/04 00:00:00.000;12;13;-1;0.025062913;0.0019176116
12835;2015/07/04 00:00:00.000;16;17;-1;0.0230169609;0.0017610719
12838;2015/07/04 00:00:00.000;2;3;-1;0.0020459521;0.0001565397
12839;2015/07/04 00:00:00.000;14;14;0;0.0265973771;0.0020350164
12845;2015/07/04 00:00:00.000;30;24;6;0.1120158766;0.0085705497
12846;2015/07/04 00:00:00.000;22;16;6;0.0291548172;0.002230691
12850;2015/07/04 00:00:00.000;14;10;4;0.0204595208;0.0015653972
12855;2015/07/04 00:00:00.000;2;1;1;0.0107412484;0.0008218335
12859;2015/07/04 00:00:00.000;4;7;-3;0.0020459521;0.0001565397
12860;2015/07/04 00:00:00.000;2;2;0;0.0040919042;0.0003130794
12865;2015/07/04 00:00:00.000;6;6;0;0.0153446406;0.0011740479
12866;2015/07/04 00:00:00.000;121;119;2;0.3795241115;0.0290381182
12870;2015/07/04 00:00:00.000;12;13;-1;0.0470568979;0.0036004136
12871;2015/07/04 00:00:00.000;13;15;-2;0.0327352333;0.0025046355
12878;2015/07/04 00:00:00.000;1;1;0;0.0056263682;0.0004304842
12885;2015/07/04 00:00:00.000;21;22;-1;0.0322237453;0.0024655006
12886;2015/07/04 00:00:00.000;1;1;0;0.0019810905;0.0001555739
12903;2015/07/04 00:00:00.000;4;5;-1;0.0127872005;0.0009783733
12910;2015/07/04 00:00:00.000;1;1;0;0.003962181;0.0003111478
12913;2015/07/04 00:00:00.000;1;2;-1;0.001022976;0.0000782699
12916;2015/07/04 00:00:00.000;3;3;0;0.0020459521;0.0001565397
12918;2015/07/04 00:00:00.000;2;2;0;0.0030689281;0.0002348096
12919;2015/07/04 00:00:00.000;11;13;-2;0.0219939849;0.001682802
12920;2015/07/04 00:00:00.000;4;5;-1;0.0225054729;0.0017219369
12921;2015/07/04 00:00:00.000;7;5;2;0.0097182724;0.0007435637
12926;2015/07/04 00:00:00.000;6;5;1;0.0076723203;0.000587024
12927;2015/07/04 00:00:00.000;1;1;0;0.0035804161;0.0002739445
12928;2015/07/04 00:00:00.000;6;5;1;0.0132986885;0.0010175082
12932;2015/07/04 00:00:00.000;4;4;0;0.0081838083;0.0006261589
12934;2015/07/04 00:00:00.000;1;1;0;0.0040919042;0.0003130794
12936;2015/07/04 00:00:00.000;3;4;-1;0.0056263682;0.0004304842
12937;2015/07/04 00:00:00.000;1;1;0;0.0025574401;0.0001956747
12941;2015/07/04 00:00:00.000;13;12;1;0.0102297604;0.0007826986
12946;2015/07/04 00:00:00.000;32;31;1;0.072631299;0.0055571601
12952;2015/07/04 00:00:00.000;1;1;0;0.0025574401;0.0001956747
12953;2015/07/04 00:00:00.000;30;35;-5;0.0654704667;0.0050092711
12955;2015/07/04 00:00:00.000;1;1;0;0.001022976;0.0000782699
12958;2015/07/04 00:00:00.000;2;2;0;0.0086952964;0.0006652938
12962;2015/07/04 00:00:00.000;15;17;-2;0.0225054729;0.0017219369
12966;2015/07/04 00:00:00.000;1;1;0;0.0015344641;0.0001174048
12970;2015/07/04 00:00:00.000;2;2;0;0.0015344641;0.0001174048
12972;2015/07/04 00:00:00.000;12;11;1;0.024039937;0.0018393417
12978;2015/07/04 00:00:00.000;1;1;0;0.0015344641;0.0001174048
12980;2015/07/04 00:00:00.000;2;3;-1;0.0020459521;0.0001565397
12981;2015/07/04 00:00:00.000;3;2;1;0.0153446406;0.0011740479
12986;2015/07/04 00:00:00.000;18;15;3;0.0317122573;0.0024263657
12987;2015/07/04 00:00:00.000;4;4;0;0.001022976;0.0000782699
12993;2015/07/04 00:00:00.000;4;4;0;0.0127872005;0.0009783733
13026;2015/07/04 00:00:00.000;4;6;-2;0.0061378563;0.0004696192
13027;2015/07/04 00:00:00.000;192;204;-12;0.1401477177;0.0107229709
13030;2015/07/04 00:00:00.000;17;18;-1;0.0158561286;0.0012131828
13031;2015/07/04 00:00:00.000;33;37;-4;0.0670049307;0.0051266759
13034;2015/07/04 00:00:00.000;8;8;0;0.0076723203;0.000587024
13035;2015/07/04 00:00:00.000;34;33;1;0.1033205802;0.0079052559
13036;2015/07/04 00:00:00.000;22;28;-6;0.0163676167;0.0012523178
13037;2015/07/04 00:00:00.000;23;27;-4;0.0404075537;0.0030916595
13040;2015/07/04 00:00:00.000;3;5;-2;0.0020459521;0.0001565397
13041;2015/07/04 00:00:00.000;46;48;-2;0.074165763;0.0056745649
13044;2015/07/04 00:00:00.000;9;8;1;0.0051148802;0.0003913493
13045;2015/07/04 00:00:00.000;64;56;8;0.0639360026;0.0048918663
13052;2015/07/04 00:00:00.000;2;2;0;0.0112527365;0.0008609685
13053;2015/07/04 00:00:00.000;9;10;-1;0.0204595208;0.0015653972
13057;2015/07/04 00:00:00.000;36;38;-2;0.0424535057;0.0032481992
13066;2015/07/04 00:00:00.000;59;65;-6;0.0843955235;0.0064572635
13068;2015/07/04 00:00:00.000;11;9;2;0.0143216646;0.001095778
13069;2015/07/04 00:00:00.000;64;83;-19;0.0444994578;0.0034047389
13072;2015/07/04 00:00:00.000;3;3;0;0.003962181;0.0003111478
13073;2015/07/04 00:00:00.000;14;14;0;0.0230169609;0.0017610719
13074;2015/07/04 00:00:00.000;7;12;-5;0.0051148802;0.0003913493
13076;2015/07/04 00:00:00.000;4;3;1;0.0030689281;0.0002348096
13077;2015/07/04 00:00:00.000;16;15;1;0.025574401;0.0019567465
13078;2015/07/04 00:00:00.000;28;26;2;0.074165763;0.0056745649
13080;2015/07/04 00:00:00.000;12;14;-2;0.0163676167;0.0012523178
13081;2015/07/04 00:00:00.000;1;1;0;0.0020459521;0.0001565397
13082;2015/07/04 00:00:00.000;9;10;-1;0.023528449;0.0018002068
13083;2015/07/04 00:00:00.000;2;2;0;0.0030689281;0.0002348096
13084;2015/07/04 00:00:00.000;10;9;1;0.0158561286;0.0012131828
13088;2015/07/04 00:00:00.000;49;44;5;0.0813265953;0.0062224539
13090;2015/07/04 00:00:00.000;69;77;-8;0.1570268224;0.0120144236
13092;2015/07/04 00:00:00.000;10;10;0;0.0066493443;0.0005087541
13101;2015/07/04 00:00:00.000;5;4;1;0.0035804161;0.0002739445
13104;2015/07/04 00:00:00.000;84;92;-8;0.098717188;0.0075530415
13108;2015/07/04 00:00:00.000;22;25;-3;0.0189250568;0.0014479924
13110;2015/07/04 00:00:00.000;5;7;-2;0.0051148802;0.0003913493
13111;2015/07/04 00:00:00.000;3;3;0;0.0014858179;0.0001166804
13112;2015/07/04 00:00:00.000;6;6;0;0.001022976;0.0000782699
13114;2015/07/04 00:00:00.000;15;14;1;0.0199480328;0.0015262623
13116;2015/07/04 00:00:00.000;4;5;-1;0.0092067844;0.0007044287
13118;2015/07/04 00:00:00.000;7;6;1;0.0086952964;0.0006652938
13120;2015/07/04 00:00:00.000;3;2;1;0.0035804161;0.0002739445
13122;2015/07/04 00:00:00.000;1;1;0;0.0015344641;0.0001174048
13126;2015/07/04 00:00:00.000;56;67;-11;0.0700738589;0.0053614854
13131;2015/07/04 00:00:00.000;8;9;-1;0.0081838083;0.0006261589
13132;2015/07/04 00:00:00.000;9;9;0;0.0225054729;0.0017219369
13140;2015/07/04 00:00:00.000;6;8;-2;0.0040919042;0.0003130794
13143;2015/07/04 00:00:00.000;3;4;-1;0.0025574401;0.0001956747
13144;2015/07/04 00:00:00.000;4;6;-2;0.001022976;0.0000782699
13148;2015/07/04 00:00:00.000;17;10;7;0.0332467214;0.0025437705
13152;2015/07/04 00:00:00.000;29;30;-1;0.1391247417;0.010644701
13156;2015/07/04 00:00:00.000;7;9;-2;0.0061378563;0.0004696192
13157;2015/07/04 00:00:00.000;6;6;0;0.0030689281;0.0002348096
13167;2015/07/04 00:00:00.000;11;10;1;0.0081838083;0.0006261589
13205;2015/07/04 00:00:00.000;24;24;0;0.0659819547;0.005048406
13206;2015/07/04 00:00:00.000;36;41;-5;0.1012746281;0.0077487162
13210;2015/07/04 00:00:00.000;17;20;-3;0.0455224339;0.0034830088
13211;2015/07/04 00:00:00.000;38;32;6;0.0204595208;0.0015653972
13215;2015/07/04 00:00:00.000;33;31;2;0.0849070115;0.0064963984
13224;2015/07/04 00:00:00.000;18;22;-4;0.0281318412;0.0021524212
13304;2015/07/04 00:00:00.000;7;9;-2;0.0086952964;0.0006652938
13310;2015/07/04 00:00:00.000;1;1;0;0.0204595208;0.0015653972
13316;2015/07/04 00:00:00.000;4;4;0;0.0301777932;0.0023089609
13317;2015/07/04 00:00:00.000;7;6;1;0.0306892813;0.0023480958
13322;2015/07/04 00:00:00.000;2;3;-1;0.0015344641;0.0001174048
13326;2015/07/04 00:00:00.000;24;26;-2;0.0946252839;0.0072399621
13327;2015/07/04 00:00:00.000;3;3;0;0.0086952964;0.0006652938
13332;2015/07/04 00:00:00.000;5;4;1;0.0071608323;0.000547889
13333;2015/07/04 00:00:00.000;2;1;1;0.0019810905;0.0001555739
13337;2015/07/04 00:00:00.000;10;8;2;0.0056263682;0.0004304842
13338;2015/07/04 00:00:00.000;4;4;0;0.0296663052;0.002269826
13346;2015/07/04 00:00:00.000;9;7;2;0.0179020807;0.0013697226
13348;2015/07/04 00:00:00.000;7;8;-1;0.0066493443;0.0005087541
13354;2015/07/04 00:00:00.000;9;7;2;0.0071608323;0.000547889
13361;2015/07/04 00:00:00.000;1;2;-1;0.0056263682;0.0004304842
13365;2015/07/04 00:00:00.000;19;14;5;0.024551425;0.0018784766
13367;2015/07/04 00:00:00.000;25;21;4;0.0276203531;0.0021132862
13403;2015/07/04 00:00:00.000;8;7;1;0.0117642245;0.0009001034
13408;2015/07/04 00:00:00.000;9;7;2;0.0086952964;0.0006652938
13409;2015/07/04 00:00:00.000;2;2;0;0.0044574536;0.0003500413
13413;2015/07/04 00:00:00.000;30;27;3;0.0869529636;0.0066529381
13424;2015/07/04 00:00:00.000;6;7;-1;0.0051148802;0.0003913493
13425;2015/07/04 00:00:00.000;2;2;0;0.000511488;0.0000391349
13433;2015/07/04 00:00:00.000;3;3;0;0.000511488;0.0000391349
13438;2015/07/04 00:00:00.000;8;5;3;0.0199480328;0.0015262623
13439;2015/07/04 00:00:00.000;11;11;0;0.0337582094;0.0025829054
13450;2015/07/04 00:00:00.000;1;1;0;0.0004952726;0.0000388935
13456;2015/07/04 00:00:00.000;6;7;-1;0.0168791047;0.0012914527
13464;2015/07/04 00:00:00.000;3;4;-1;0.0015344641;0.0001174048
13469;2015/07/04 00:00:00.000;1;2;-1;0.001022976;0.0000782699
13470;2015/07/04 00:00:00.000;3;2;1;0.0046033922;0.0003522144
13473;2015/07/04 00:00:00.000;3;3;0;0.0015344641;0.0001174048
13480;2015/07/04 00:00:00.000;4;4;0;0.0158561286;0.0012131828
13485;2015/07/04 00:00:00.000;2;2;0;0.0015344641;0.0001174048
13486;2015/07/04 00:00:00.000;1;1;0;0.003962181;0.0003111478
13491;2015/07/04 00:00:00.000;3;3;0;0.0030689281;0.0002348096
13492;2015/07/04 00:00:00.000;27;26;1;0.0526832662;0.0040308978
13501;2015/07/04 00:00:00.000;41;40;1;0.0751887391;0.0057528347
13502;2015/07/04 00:00:00.000;44;40;4;0.0710968349;0.0054397553
13601;2015/07/04 00:00:00.000;124;124;0;0.1053665323;0.0080617956
13605;2015/07/04 00:00:00.000;16;16;0;0.0046033922;0.0003522144
13606;2015/07/04 00:00:00.000;6;5;1;0.0046033922;0.0003522144
13615;2015/07/04 00:00:00.000;6;7;-1;0.000511488;0.0000391349
13619;2015/07/04 00:00:00.000;44;41;3;0.0127872005;0.0009783733
13620;2015/07/04 00:00:00.000;5;4;1;0.0030689281;0.0002348096
13624;2015/07/04 00:00:00.000;22;19;3;0.0265973771;0.0020350164
13630;2015/07/04 00:00:00.000;4;5;-1;0.001022976;0.0000782699
13633;2015/07/04 00:00:00.000;1;1;0;0.001022976;0.0000782699
13634;2015/07/04 00:00:00.000;19;16;3;0.0061378563;0.0004696192
13639;2015/07/04 00:00:00.000;1;1;0;0.0004660332;0.0000367031
13650;2015/07/04 00:00:00.000;4;5;-1;0.0199480328;0.0015262623
13656;2015/07/04 00:00:00.000;8;7;1;0.0051148802;0.0003913493
13659;2015/07/04 00:00:00.000;1;1;0;0.0015344641;0.0001174048
13660;2015/07/04 00:00:00.000;1;1;0;0.0025574401;0.0001956747
13666;2015/07/04 00:00:00.000;1;1;0;0.000511488;0.0000391349
13667;2015/07/04 00:00:00.000;3;3;0;0.0035804161;0.0002739445
13670;2015/07/04 00:00:00.000;3;4;-1;0.0019810905;0.0001555739
13676;2015/07/04 00:00:00.000;8;8;0;0.0148331526;0.001134913
13680;2015/07/04 00:00:00.000;2;2;0;0.0015344641;0.0001174048
13681;2015/07/04 00:00:00.000;1;1;0;0.000511488;0.0000391349
13685;2015/07/04 00:00:00.000;12;13;-1;0.0066493443;0.0005087541
13687;2015/07/04 00:00:00.000;1;1;0;0.0019810905;0.0001555739
13691;2015/07/04 00:00:00.000;9;8;1;0.0117642245;0.0009001034
13697;2015/07/04 00:00:00.000;2;2;0;0.0025574401;0.0001956747
13730;2015/07/04 00:00:00.000;9;12;-3;0.0081838083;0.0006261589
13731;2015/07/04 00:00:00.000;6;6;0;0.0168791047;0.0012914527
13736;2015/07/04 00:00:00.000;3;3;0;0.0035804161;0.0002739445
13740;2015/07/04 00:00:00.000;4;4;0;0.0107412484;0.0008218335
13743;2015/07/04 00:00:00.000;10;9;1;0.0081838083;0.0006261589
13746;2015/07/04 00:00:00.000;2;2;0;0.0015344641;0.0001174048
13752;2015/07/04 00:00:00.000;4;3;1;0.0030689281;0.0002348096
13754;2015/07/04 00:00:00.000;6;5;1;0.023528449;0.0018002068
13755;2015/07/04 00:00:00.000;3;4;-1;0.0040919042;0.0003130794
13760;2015/07/04 00:00:00.000;330;326;4;0.122757125;0.0093923832
13775;2015/07/04 00:00:00.000;6;7;-1;0.0035804161;0.0002739445
13776;2015/07/04 00:00:00.000;9;8;1;0.0015344641;0.0001174048
13780;2015/07/04 00:00:00.000;3;4;-1;0.0030689281;0.0002348096
13782;2015/07/04 00:00:00.000;2;2;0;0.0051148802;0.0003913493
13787;2015/07/04 00:00:00.000;9;8;1;0.0097182724;0.0007435637
13788;2015/07/04 00:00:00.000;2;2;0;0.0030689281;0.0002348096
13795;2015/07/04 00:00:00.000;4;5;-1;0.0035804161;0.0002739445
13796;2015/07/04 00:00:00.000;8;10;-2;0.0107412484;0.0008218335
13804;2015/07/04 00:00:00.000;2;2;0;0.0061378563;0.0004696192
13806;2015/07/04 00:00:00.000;1;1;0;0.000511488;0.0000391349
13810;2015/07/04 00:00:00.000;3;2;1;0.0020459521;0.0001565397
13811;2015/07/04 00:00:00.000;11;11;0;0.0153446406;0.0011740479
13815;2015/07/04 00:00:00.000;37;39;-2;0.0409190417;0.0031307944
13827;2015/07/04 00:00:00.000;16;17;-1;0.0260858891;0.0019958814
13833;2015/07/04 00:00:00.000;4;3;1;0.0051148802;0.0003913493
13839;2015/07/04 00:00:00.000;3;3;0;0.0097182724;0.0007435637
13843;2015/07/04 00:00:00.000;8;7;1;0.0117642245;0.0009001034
13844;2015/07/04 00:00:00.000;2;2;0;0.0020459521;0.0001565397
13846;2015/07/04 00:00:00.000;2;2;0;0.001022976;0.0000782699
13856;2015/07/04 00:00:00.000;18;14;4;0.0358041615;0.0027394451
13861;2015/07/04 00:00:00.000;1;1;0;0.0020459521;0.0001565397
13862;2015/07/04 00:00:00.000;9;9;0;0.0153446406;0.0011740479
13901;2015/07/04 00:00:00.000;23;24;-1;0.0542177302;0.0041483026
13905;2015/07/04 00:00:00.000;70;64;6;0.1028090922;0.007866121
14001;2015/09/05 00:00:00.000;22;15;7;0.0627081364;0.0049846703
14001;2015/07/04 00:00:00.000;17;21;-4;0.0322237453;0.0024655006
14004;2015/09/05 00:00:00.000;30;26;4;0.040855301;0.0032475882
14004;2015/07/04 00:00:00.000;22;16;6;0.024039937;0.0018393417
14005;2015/07/04 00:00:00.000;1;2;-1;0.000511488;0.0000391349
14005;2015/09/05 00:00:00.000;2;2;0;0.0042755548;0.0003398639
14006;2015/09/05 00:00:00.000;26;28;-2;0.0489313488;0.0038895533
14006;2015/07/04 00:00:00.000;38;35;3;0.0434764818;0.0033264691
14008;2015/09/05 00:00:00.000;2;2;0;0.0014251849;0.000113288
14008;2015/07/04 00:00:00.000;1;1;0;0.0046033922;0.0003522144
14009;2015/09/05 00:00:00.000;15;12;3;0.0137767875;0.0010951169
14009;2015/07/04 00:00:00.000;15;15;0;0.0102297604;0.0007826986
14011;2015/07/04 00:00:00.000;14;16;-2;0.0066493443;0.0005087541
14011;2015/09/05 00:00:00.000;10;10;0;0.0114014793;0.0009063037
14012;2015/07/04 00:00:00.000;6;5;1;0.0025574401;0.0001956747
14012;2015/09/05 00:00:00.000;5;3;2;0.005225678;0.0004153892
14013;2015/09/05 00:00:00.000;1;1;0;0.0023753082;0.0001888133
14020;2015/07/04 00:00:00.000;31;34;-3;0.0271088651;0.0020741513
14020;2015/09/05 00:00:00.000;31;31;0;0.0688839377;0.0054755847
14024;2015/07/04 00:00:00.000;3;3;0;0.0020459521;0.0001565397
14024;2015/09/05 00:00:00.000;4;4;0;0.0019002466;0.0001510506
14025;2015/07/04 00:00:00.000;6;9;-3;0.0153446406;0.0011740479
14025;2015/09/05 00:00:00.000;6;7;-1;0.0180523423;0.0014349808
14026;2015/09/05 00:00:00.000;1;1;0;0.0019002466;0.0001510506
14026;2015/07/04 00:00:00.000;1;2;-1;0.0009320663;0.0000734062
14028;2015/09/05 00:00:00.000;4;3;1;0.0019002466;0.0001510506
14030;2015/07/04 00:00:00.000;2;2;0;0.0035804161;0.0002739445
14030;2015/09/05 00:00:00.000;2;1;1;0.0004750616;0.0000377627
14031;2015/07/04 00:00:00.000;25;24;1;0.0577981464;0.0044222471
14031;2015/09/05 00:00:00.000;40;29;11;0.046080979;0.0036629774
14032;2015/09/05 00:00:00.000;19;14;5;0.0304039449;0.0024168098
14032;2015/07/04 00:00:00.000;20;15;5;0.0296663052;0.002269826
14033;2015/07/04 00:00:00.000;5;5;0;0.0127872005;0.0009783733
14033;2015/09/05 00:00:00.000;3;3;0;0.0099762944;0.0007930157
14034;2015/09/05 00:00:00.000;4;4;0;0.0028503698;0.0002265759
14034;2015/07/04 00:00:00.000;2;4;-2;0.0025574401;0.0001956747
14036;2015/07/04 00:00:00.000;5;4;1;0.0102297604;0.0007826986
14036;2015/09/05 00:00:00.000;6;6;0;0.0099762944;0.0007930157
14037;2015/07/04 00:00:00.000;3;3;0;0.0046033922;0.0003522144
14037;2015/09/05 00:00:00.000;2;2;0;0.0009501233;0.0000755253
14040;2015/07/04 00:00:00.000;3;3;0;0.0051148802;0.0003913493
14040;2015/09/05 00:00:00.000;6;5;1;0.0023753082;0.0001888133
14042;2015/07/04 00:00:00.000;3;4;-1;0.0056263682;0.0004304842
14042;2015/09/05 00:00:00.000;8;7;1;0.0042755548;0.0003398639
14043;2015/07/04 00:00:00.000;39;37;2;0.0567751703;0.0043439773
14043;2015/09/05 00:00:00.000;51;41;10;0.0584325816;0.0046448064
14047;2015/07/04 00:00:00.000;21;20;1;0.0117642245;0.0009001034
14047;2015/09/05 00:00:00.000;17;17;0;0.0194775272;0.0015482688
14048;2015/07/04 00:00:00.000;14;11;3;0.024551425;0.0018784766
14048;2015/09/05 00:00:00.000;36;26;10;0.0247032052;0.001963658
14051;2015/07/04 00:00:00.000;55;60;-5;0.1089469485;0.0083357401
14051;2015/09/05 00:00:00.000;59;47;12;0.0992878826;0.0078923946
14052;2015/09/05 00:00:00.000;37;25;12;0.0931120813;0.0074014801
14052;2015/07/04 00:00:00.000;27;27;0;0.1074124844;0.0082183353
14054;2015/07/04 00:00:00.000;1;1;0;0.000511488;0.0000391349
14054;2015/09/05 00:00:00.000;1;1;0;0.0004577916;0.000036346
14055;2015/07/04 00:00:00.000;3;3;0;0.0071608323;0.000547889
14055;2015/09/05 00:00:00.000;12;10;2;0.0004750616;0.0000377627
14057;2015/09/05 00:00:00.000;14;8;6;0.0228029587;0.0018126074
14057;2015/07/04 00:00:00.000;17;13;4;0.0214824969;0.0016436671
14058;2015/07/04 00:00:00.000;3;4;-1;0.000511488;0.0000391349
14058;2015/09/05 00:00:00.000;6;5;1;0.0023753082;0.0001888133
14059;2015/09/05 00:00:00.000;22;18;4;0.0608078898;0.0048336196
14060;2015/09/05 00:00:00.000;1;1;0;0.0004577916;0.000036346
14062;2015/09/05 00:00:00.000;2;2;0;0.0023753082;0.0001888133
14063;2015/09/05 00:00:00.000;49;43;6;0.0213777738;0.0016993194
14065;2015/07/04 00:00:00.000;7;8;-1;0.0040919042;0.0003130794
14065;2015/09/05 00:00:00.000;6;5;1;0.0033254315;0.0002643386
14066;2015/09/05 00:00:00.000;3;2;1;0.0014251849;0.000113288
14066;2015/07/04 00:00:00.000;3;2;1;0.000511488;0.0000391349
14067;2015/09/05 00:00:00.000;5;3;2;0.0104513561;0.0008307784
14068;2015/07/04 00:00:00.000;17;17;0;0.0470568979;0.0036004136
14068;2015/09/05 00:00:00.000;15;19;-4;0.0242281436;0.0019258953
14069;2015/07/04 00:00:00.000;3;3;0;0.0086952964;0.0006652938
14069;2015/09/05 00:00:00.000;3;1;2;0.0023753082;0.0001888133
14070;2015/09/05 00:00:00.000;16;12;4;0.011876541;0.0009440663
14070;2015/07/04 00:00:00.000;19;20;-1;0.025062913;0.0019176116
14072;2015/07/04 00:00:00.000;46;47;-1;0.0803036193;0.006144184
14080;2015/09/05 00:00:00.000;7;6;1;0.0247032052;0.001963658
14080;2015/07/04 00:00:00.000;6;5;1;0.0086952964;0.0006652938
14081;2015/07/04 00:00:00.000;6;4;2;0.0066493443;0.0005087541
14081;2015/09/05 00:00:00.000;7;5;2;0.0042755548;0.0003398639
14082;2015/07/04 00:00:00.000;1;1;0;0.0040919042;0.0003130794
14085;2015/09/05 00:00:00.000;23;22;1;0.0194775272;0.0015482688
14086;2015/07/04 00:00:00.000;54;55;-1;0.1381017657;0.0105664312
14092;2015/09/05 00:00:00.000;35;31;4;0.051306657;0.0040783666
14094;2015/07/04 00:00:00.000;123;111;12;0.1672565829;0.0127971222
14098;2015/09/05 00:00:00.000;4;3;1;0.0076009862;0.0006042025
14101;2015/09/05 00:00:00.000;4;4;0;0.0038004931;0.0003021012
14101;2015/07/04 00:00:00.000;2;4;-2;0.0015344641;0.0001174048
14102;2015/09/05 00:00:00.000;1;1;0;0.0033254315;0.0002643386
14102;2015/07/04 00:00:00.000;1;1;0;0.0015344641;0.0001174048
14103;2015/07/04 00:00:00.000;18;17;1;0.0260858891;0.0019958814
14105;2015/07/04 00:00:00.000;7;6;1;0.0071608323;0.000547889
14105;2015/09/05 00:00:00.000;4;5;-1;0.0080760479;0.0006419651
14108;2015/07/04 00:00:00.000;9;12;-3;0.0127872005;0.0009783733
14108;2015/09/05 00:00:00.000;11;6;5;0.0123516026;0.000981829
14111;2015/07/04 00:00:00.000;7;7;0;0.0076723203;0.000587024
14111;2015/09/05 00:00:00.000;9;6;3;0.0014251849;0.000113288
14113;2015/09/05 00:00:00.000;1;1;0;0.0004750616;0.0000377627
14113;2015/07/04 00:00:00.000;1;1;0;0.001022976;0.0000782699
14120;2015/09/05 00:00:00.000;76;67;9;0.1273165193;0.0101203911
14120;2015/07/04 00:00:00.000;66;71;-5;0.1406592058;0.0107621058
14125;2015/09/05 00:00:00.000;3;4;-1;0.0038004931;0.0003021012
14126;2015/07/04 00:00:00.000;5;4;1;0.000511488;0.0000391349
14127;2015/09/05 00:00:00.000;65;63;2;0.1591456491;0.0126504889
14127;2015/07/04 00:00:00.000;81;83;-2;0.2869447798;0.0219546958
14129;2015/09/05 00:00:00.000;2;2;0;0.0009501233;0.0000755253
14129;2015/07/04 00:00:00.000;2;2;0;0.0025574401;0.0001956747
14131;2015/09/05 00:00:00.000;7;5;2;0.0109264177;0.000868541
14131;2015/07/04 00:00:00.000;3;4;-1;0.0153446406;0.0011740479
14132;2015/09/05 00:00:00.000;11;8;3;0.0147269108;0.0011706423
14132;2015/07/04 00:00:00.000;5;6;-1;0.0148331526;0.001134913
14136;2015/09/05 00:00:00.000;20;18;2;0.0142518492;0.0011328796
14138;2015/09/05 00:00:00.000;11;8;3;0.0028503698;0.0002265759
14138;2015/07/04 00:00:00.000;2;2;0;0.0023301659;0.0001835155
14139;2015/07/04 00:00:00.000;2;2;0;0.0102297604;0.0007826986
14141;2015/07/04 00:00:00.000;12;12;0;0.0301777932;0.0023089609
14141;2015/09/05 00:00:00.000;11;10;1;0.0080760479;0.0006419651
14145;2015/09/05 00:00:00.000;1;1;0;0.0019002466;0.0001510506
14150;2015/09/05 00:00:00.000;72;71;1;0.1368177521;0.0108756442
14166;2015/09/05 00:00:00.000;4;4;0;0.0009501233;0.0000755253
14167;2015/07/04 00:00:00.000;5;3;2;0.0030689281;0.0002348096
14167;2015/09/05 00:00:00.000;1;1;0;0.0023753082;0.0001888133
14170;2015/07/04 00:00:00.000;4;6;-2;0.0061378563;0.0004696192
14170;2015/09/05 00:00:00.000;2;3;-1;0.0099762944;0.0007930157
14171;2015/09/05 00:00:00.000;8;6;2;0.0019002466;0.0001510506
14172;2015/07/04 00:00:00.000;12;12;0;0.0143216646;0.001095778
14172;2015/09/05 00:00:00.000;9;9;0;0.0128266643;0.0010195916
14173;2015/09/05 00:00:00.000;1;1;0;0.0023753082;0.0001888133
14201;2015/07/04 00:00:00.000;4;4;0;0.0782576672;0.0059876443
14202;2015/07/04 00:00:00.000;8;7;1;0.0260858891;0.0019958814
14202;2015/09/05 00:00:00.000;4;2;2;0.040855301;0.0032475882
14204;2015/07/04 00:00:00.000;1;1;0;0.0127872005;0.0009783733
14206;2015/09/05 00:00:00.000;124;134;-10;0.063183198;0.0050224329
14207;2015/07/04 00:00:00.000;20;20;0;0.0552407063;0.0042265725
14208;2015/07/04 00:00:00.000;3;2;1;0.0153446406;0.0011740479
14208;2015/09/05 00:00:00.000;3;3;0;0.0593827049;0.0047203317
14209;2015/09/05 00:00:00.000;5;3;2;0.081710602;0.0064951764
14210;2015/09/05 00:00:00.000;14;8;6;0.0441807325;0.0035119268
14210;2015/07/04 00:00:00.000;22;18;4;0.0409190417;0.0031307944
14211;2015/09/05 00:00:00.000;22;17;5;0.063183198;0.0050224329
14211;2015/07/04 00:00:00.000;16;15;1;0.0516602901;0.0039526279
14213;2015/07/04 00:00:00.000;6;6;0;0.121734149;0.0093141134
14213;2015/09/05 00:00:00.000;6;6;0;0.1254162728;0.0099693405
14214;2015/09/05 00:00:00.000;10;7;3;0.0646083829;0.0051357209
14214;2015/07/04 00:00:00.000;13;10;3;0.0762117151;0.0058311046
14216;2015/09/05 00:00:00.000;26;24;2;0.1643713272;0.0130658781
14216;2015/07/04 00:00:00.000;25;25;0;0.1616302146;0.0123666379
14217;2015/07/04 00:00:00.000;120;106;14;0.1452625979;0.0111143202
14217;2015/09/05 00:00:00.000;58;41;17;0.0755348006;0.0060042619
14218;2015/07/04 00:00:00.000;60;48;12;0.0373386255;0.0028568499
14218;2015/09/05 00:00:00.000;42;30;12;0.0479812256;0.003814028
14219;2015/09/05 00:00:00.000;44;40;4;0.0304039449;0.0024168098
14219;2015/07/04 00:00:00.000;52;50;2;0.0086952964;0.0006652938
14220;2015/07/04 00:00:00.000;23;25;-2;0.072119811;0.0055180252
14220;2015/09/05 00:00:00.000;21;22;-1;0.0840859101;0.0066839897
14221;2015/09/05 00:00:00.000;492;354;138;0.2532078537;0.0201274943
14221;2015/07/04 00:00:00.000;132;142;-10;0.2562554985;0.0196066
14222;2015/09/05 00:00:00.000;11;7;4;0.1059387456;0.0084210717
14223;2015/09/05 00:00:00.000;116;124;-8;0.0916868964;0.0072881921
14223;2015/07/04 00:00:00.000;62;64;-2;0.1176422448;0.0090010339
14224;2015/07/04 00:00:00.000;136;140;-4;0.1815782474;0.0138929002
14225;2015/09/05 00:00:00.000;242;230;12;0.1292167659;0.0102714417
14226;2015/09/05 00:00:00.000;77;59;18;0.1691219436;0.0134435046
14227;2015/07/04 00:00:00.000;200;196;4;0.0782576672;0.0059876443
14228;2015/07/04 00:00:00.000;53;58;-5;0.0618900505;0.0047353266
14228;2015/09/05 00:00:00.000;70;60;10;0.0646083829;0.0051357209
14303;2015/09/05 00:00:00.000;11;9;2;0.0323041915;0.0025678604
14303;2015/07/04 00:00:00.000;6;5;1;0.0138101766;0.0010566431
14305;2015/09/05 00:00:00.000;26;25;1;0.0532069036;0.0042294172
14305;2015/07/04 00:00:00.000;33;27;6;0.0383616016;0.0029351198
14414;2015/09/05 00:00:00.000;2;3;-1;0.0095012328;0.0007552531
14414;2015/07/04 00:00:00.000;7;7;0;0.0112527365;0.0008609685
14418;2015/07/04 00:00:00.000;1;1;0;0.0066493443;0.0005087541
14420;2015/07/04 00:00:00.000;20;18;2;0.0276203531;0.0021132862
14420;2015/09/05 00:00:00.000;25;20;5;0.0266034518;0.0021147086
14422;2015/09/05 00:00:00.000;1;1;0;0.0028503698;0.0002265759
14423;2015/07/04 00:00:00.000;9;8;1;0.0092067844;0.0007044287
14424;2015/09/05 00:00:00.000;50;52;-2;0.1273165193;0.0101203911
14425;2015/09/05 00:00:00.000;27;28;-1;0.0180523423;0.0014349808
14425;2015/07/04 00:00:00.000;17;16;1;0.0189250568;0.0014479924
14427;2015/07/04 00:00:00.000;5;7;-2;0.0020459521;0.0001565397
14428;2015/09/05 00:00:00.000;5;7;-2;0.0133017259;0.0010573543
14432;2015/07/04 00:00:00.000;7;8;-1;0.0071608323;0.000547889
14432;2015/09/05 00:00:00.000;11;7;4;0.005225678;0.0004153892
14435;2015/07/04 00:00:00.000;8;10;-2;0.0076723203;0.000587024
14437;2015/07/04 00:00:00.000;20;23;-3;0.0132986885;0.0010175082
14437;2015/09/05 00:00:00.000;16;19;-3;0.0204276505;0.0016237941
14441;2015/09/05 00:00:00.000;1;1;0;0.0028503698;0.0002265759
14450;2015/09/05 00:00:00.000;53;54;-1;0.1600957724;0.0127260142
14450;2015/07/04 00:00:00.000;52;64;-12;0.2158479448;0.0165149405
14454;2015/09/05 00:00:00.000;12;11;1;0.0204276505;0.0016237941
14454;2015/07/04 00:00:00.000;14;14;0;0.0117642245;0.0009001034
14456;2015/09/05 00:00:00.000;33;29;4;0.098812821;0.0078546319
14456;2015/07/04 00:00:00.000;28;27;1;0.072119811;0.0055180252
14462;2015/07/04 00:00:00.000;1;1;0;0.0009905452;0.000077787
14462;2015/09/05 00:00:00.000;1;1;0;0.0066508629;0.0005286771
14466;2015/09/05 00:00:00.000;3;2;1;0.0023753082;0.0001888133
14466;2015/07/04 00:00:00.000;3;3;0;0.0040919042;0.0003130794
14467;2015/09/05 00:00:00.000;7;5;2;0.0232780203;0.00185037
14467;2015/07/04 00:00:00.000;7;6;1;0.024551425;0.0018784766
14469;2015/07/04 00:00:00.000;7;10;-3;0.0291548172;0.002230691
14470;2015/09/05 00:00:00.000;14;12;2;0.0080760479;0.0006419651
14470;2015/07/04 00:00:00.000;9;8;1;0.024551425;0.0018784766
14471;2015/09/05 00:00:00.000;8;8;0;0.0095012328;0.0007552531
14475;2015/09/05 00:00:00.000;1;1;0;0.0009501233;0.0000755253
14476;2015/09/05 00:00:00.000;5;4;1;0.0061758013;0.0004909145
14477;2015/09/05 00:00:00.000;3;4;-1;0.0047506164;0.0003776265
14478;2015/09/05 00:00:00.000;1;1;0;0.0080760479;0.0006419651
14478;2015/07/04 00:00:00.000;2;2;0;0.0040919042;0.0003130794
14481;2015/09/05 00:00:00.000;1;1;0;0.0014251849;0.000113288
14482;2015/07/04 00:00:00.000;7;8;-1;0.0086952964;0.0006652938
14482;2015/09/05 00:00:00.000;5;5;0;0.0047506164;0.0003776265
14485;2015/07/04 00:00:00.000;1;2;-1;0.0020459521;0.0001565397
14487;2015/09/05 00:00:00.000;8;10;-2;0.0166271574;0.0013216929
14487;2015/07/04 00:00:00.000;8;9;-1;0.0097182724;0.0007435637
14489;2015/09/05 00:00:00.000;9;9;0;0.0128266643;0.0010195916
14502;2015/07/04 00:00:00.000;8;11;-3;0.024039937;0.0018393417
14502;2015/09/05 00:00:00.000;15;10;5;0.0218528354;0.0017370821
14504;2015/07/04 00:00:00.000;3;3;0;0.0071608323;0.000547889
14505;2015/09/05 00:00:00.000;4;3;1;0.0071259246;0.0005664398
14506;2015/07/04 00:00:00.000;5;6;-1;0.0066493443;0.0005087541
14507;2015/07/04 00:00:00.000;5;4;1;0.0076723203;0.000587024
14510;2015/09/05 00:00:00.000;3;3;0;0.0085511095;0.0006797278
14510;2015/07/04 00:00:00.000;9;8;1;0.0071608323;0.000547889
14511;2015/07/04 00:00:00.000;1;2;-1;0.000511488;0.0000391349
14512;2015/09/05 00:00:00.000;5;4;1;0.0261283902;0.0020769459
14513;2015/09/05 00:00:00.000;18;13;5;0.0156770341;0.0012461676
14513;2015/07/04 00:00:00.000;26;26;0;0.0214824969;0.0016436671
14514;2015/07/04 00:00:00.000;4;2;2;0.0296663052;0.002269826
14516;2015/09/05 00:00:00.000;4;4;0;0.0028503698;0.0002265759
14516;2015/07/04 00:00:00.000;4;4;0;0.000511488;0.0000391349
14517;2015/07/04 00:00:00.000;1;1;0;0.0020459521;0.0001565397
14519;2015/07/04 00:00:00.000;14;16;-2;0.0286433292;0.0021915561
14519;2015/09/05 00:00:00.000;12;11;1;0.0351545613;0.0027944364
14522;2015/09/05 00:00:00.000;13;10;3;0.0123516026;0.000981829
14525;2015/07/04 00:00:00.000;1;1;0;0.0025574401;0.0001956747
14526;2015/09/05 00:00:00.000;21;15;6;0.0522567803;0.0041538919
14526;2015/07/04 00:00:00.000;29;39;-10;0.0629130266;0.0048135964
14527;2015/09/05 00:00:00.000;23;24;-1;0.0427555475;0.0033986388
14530;2015/09/05 00:00:00.000;8;6;2;0.0114014793;0.0009063037
14530;2015/07/04 00:00:00.000;7;9;-2;0.0127872005;0.0009783733
14532;2015/07/04 00:00:00.000;2;5;-3;0.0071608323;0.000547889
14533;2015/09/05 00:00:00.000;4;3;1;0.0023753082;0.0001888133
14534;2015/09/05 00:00:00.000;62;46;16;0.1600957724;0.0127260142
14541;2015/07/04 00:00:00.000;5;5;0;0.0066493443;0.0005087541
14541;2015/09/05 00:00:00.000;7;7;0;0.0085511095;0.0006797278
14544;2015/07/04 00:00:00.000;5;3;2;0.0025574401;0.0001956747
14545;2015/09/05 00:00:00.000;1;1;0;0.0005241804;0.000040721
14546;2015/09/05 00:00:00.000;4;5;-1;0.0042755548;0.0003398639
14548;2015/09/05 00:00:00.000;4;3;1;0.0047506164;0.0003776265
14548;2015/07/04 00:00:00.000;9;7;2;0.0071608323;0.000547889
14551;2015/07/04 00:00:00.000;6;6;0;0.0061378563;0.0004696192
14551;2015/09/05 00:00:00.000;7;8;-1;0.0057007397;0.0004531518
14555;2015/09/05 00:00:00.000;1;1;0;0.0023753082;0.0001888133
14561;2015/07/04 00:00:00.000;2;2;0;0.0117642245;0.0009001034
14568;2015/07/04 00:00:00.000;2;3;-1;0.0097182724;0.0007435637
14569;2015/07/04 00:00:00.000;7;9;-2;0.0076723203;0.000587024
14572;2015/07/04 00:00:00.000;2;2;0;0.0061378563;0.0004696192
14580;2015/07/04 00:00:00.000;62;79;-17;0.1672565829;0.0127971222
14586;2015/07/04 00:00:00.000;13;12;1;0.0199480328;0.0015262623
14590;2015/07/04 00:00:00.000;5;7;-2;0.0086952964;0.0006652938
14591;2015/07/04 00:00:00.000;2;1;1;0.001022976;0.0000782699
14605;2015/07/04 00:00:00.000;1;1;0;0.0081838083;0.0006261589
14608;2015/07/04 00:00:00.000;8;8;0;0.0306892813;0.0023480958
14609;2015/07/04 00:00:00.000;61;83;-22;0.1196881969;0.0091575737
14610;2015/07/04 00:00:00.000;20;22;-2;0.0644474906;0.0049310012
14611;2015/07/04 00:00:00.000;16;17;-1;0.0112527365;0.0008609685
14613;2015/07/04 00:00:00.000;8;12;-4;0.0312007693;0.0023872307
14617;2015/07/04 00:00:00.000;124;140;-16;0.0777461792;0.0059485094
14618;2015/07/04 00:00:00.000;35;40;-5;0.0818380834;0.0062615888
14620;2015/07/04 00:00:00.000;18;17;1;0.072631299;0.0055571601
14621;2015/07/04 00:00:00.000;25;30;-5;0.0092067844;0.0007044287
14623;2015/07/04 00:00:00.000;19;19;0;0.0506373141;0.0038743581
14624;2015/07/04 00:00:00.000;47;52;-5;0.1334983735;0.0102142168
24211;2015/09/05 00:00:00.000;29;28;1;0.1320667653;0.0031343002
24219;2015/09/05 00:00:00.000;19;14;5;0.0445526437;0.0010573543
24221;2015/09/05 00:00:00.000;1;2;-1;0.0107158165;0.0002544221
24224;2015/09/05 00:00:00.000;2;3;-1;0.0015911658;0.0000377627
24228;2015/09/05 00:00:00.000;4;5;-1;0.0063646634;0.0001510506
24230;2015/09/05 00:00:00.000;5;4;1;0.0079558292;0.0001888133
24251;2015/09/05 00:00:00.000;28;27;1;0.0143204926;0.0003398639
24256;2015/09/05 00:00:00.000;1;1;0;0.0015911658;0.0000377627
24263;2015/09/05 00:00:00.000;3;2;1;0.0350056486;0.0008307784
24271;2015/09/05 00:00:00.000;2;4;-2;0.0031823317;0.0000755253
24273;2015/09/05 00:00:00.000;6;3;3;0.0015911658;0.0000377627
24277;2015/09/05 00:00:00.000;2;3;-1;0.0095469951;0.0002265759
24290;2015/09/05 00:00:00.000;10;10;0;0.0015911658;0.0000377627
24292;2015/09/05 00:00:00.000;1;1;0;0.0222763219;0.0005286771
24311;2015/09/05 00:00:00.000;1;1;0;0.0047734975;0.000113288
24312;2015/09/05 00:00:00.000;1;1;0;0.0111381609;0.0002643386
24317;2015/09/05 00:00:00.000;5;5;0;0.0095469951;0.0002265759
24318;2015/09/05 00:00:00.000;1;1;0;0.0063646634;0.0001510506
24324;2015/09/05 00:00:00.000;7;5;2;0.0063646634;0.0001510506
24325;2015/09/05 00:00:00.000;2;2;0;0.0111381609;0.0002643386
24330;2015/09/05 00:00:00.000;7;8;-1;0.0175028243;0.0004153892
24333;2015/09/05 00:00:00.000;22;25;-3;0.1241109361;0.002945487
24347;2015/09/05 00:00:00.000;30;24;6;0.0190939902;0.0004531518
24348;2015/09/05 00:00:00.000;5;4;1;0.0111381609;0.0002643386
24354;2015/09/05 00:00:00.000;11;10;1;0.0270498194;0.0006419651
24361;2015/09/05 00:00:00.000;2;2;0;0.0095469951;0.0002265759
24363;2015/09/05 00:00:00.000;5;4;1;0.0015911658;0.0000377627
24374;2015/09/05 00:00:00.000;2;2;0;0.0031823317;0.0000755253
24380;2015/09/05 00:00:00.000;13;11;2;0.0175028243;0.0004153892
24416;2015/09/05 00:00:00.000;25;42;-17;0.0636466339;0.0015105061
24430;2015/09/05 00:00:00.000;6;6;0;0.0111381609;0.0002643386
24431;2015/09/05 00:00:00.000;2;4;-2;0.0222763219;0.0005286771
24435;2015/09/05 00:00:00.000;4;6;-2;0.0270498194;0.0006419651
24435;2015/07/04 00:00:00.000;8;8;0;0.0031698233;0.0000782699
24437;2015/09/05 00:00:00.000;1;1;0;0.0175028243;0.0004153892
24437;2015/07/04 00:00:00.000;2;2;0;0.0142642048;0.0003522144
24439;2015/07/04 00:00:00.000;1;1;0;0.0110943815;0.0002739445
24439;2015/09/05 00:00:00.000;1;1;0;0.0143204926;0.0003398639
24440;2015/07/04 00:00:00.000;3;3;0;0.0142642048;0.0003522144
24440;2015/09/05 00:00:00.000;7;7;0;0.0111381609;0.0002643386
24441;2015/09/05 00:00:00.000;14;16;-2;0.0397791462;0.0009440663
24441;2015/07/04 00:00:00.000;9;11;-2;0.0681512006;0.001682802
24442;2015/09/05 00:00:00.000;1;1;0;0.0063646634;0.0001510506
24442;2015/07/04 00:00:00.000;1;1;0;0.0063396466;0.0001565397
24445;2015/07/04 00:00:00.000;2;4;-2;0.0158491164;0.0003913493
24445;2015/09/05 00:00:00.000;5;4;1;0.0159116585;0.0003776265
24450;2015/09/05 00:00:00.000;42;39;3;0.2657246965;0.0063063631
24450;2015/07/04 00:00:00.000;53;46;7;0.3169823282;0.007826986
24459;2015/07/04 00:00:00.000;4;3;1;0.0063396466;0.0001565397
24459;2015/09/05 00:00:00.000;4;3;1;0.0127293268;0.0003021012
24460;2015/09/05 00:00:00.000;1;1;0;0.0238674877;0.0005664398
24464;2015/07/04 00:00:00.000;1;1;0;0.0174340281;0.0004304842
24465;2015/07/04 00:00:00.000;2;2;0;0.0095094698;0.0002348096
24465;2015/09/05 00:00:00.000;3;2;1;0.0238674877;0.0005664398
24467;2015/09/05 00:00:00.000;5;6;-1;0.0270498194;0.0006419651
24467;2015/07/04 00:00:00.000;7;6;1;0.0237736746;0.000587024
24471;2015/07/04 00:00:00.000;4;5;-1;0.0174340281;0.0004304842
24472;2015/07/04 00:00:00.000;7;9;-2;0.0253585863;0.0006261589
24472;2015/09/05 00:00:00.000;8;7;1;0.0190939902;0.0004531518
24473;2015/09/05 00:00:00.000;2;2;0;0.0222763219;0.0005286771
24473;2015/07/04 00:00:00.000;2;3;-1;0.0015849116;0.0000391349
24477;2015/07/04 00:00:00.000;22;18;4;0.1806799271;0.004461382
24477;2015/09/05 00:00:00.000;41;42;-1;0.1018346142;0.0024168098
24479;2015/09/05 00:00:00.000;6;8;-2;0.0111381609;0.0002643386
24479;2015/07/04 00:00:00.000;3;2;1;0.0063396466;0.0001565397
24482;2015/07/04 00:00:00.000;10;12;-2;0.0554719074;0.0013697226
24482;2015/09/05 00:00:00.000;10;10;0;0.0429614779;0.0010195916
24483;2015/09/05 00:00:00.000;5;4;1;0.0063646634;0.0001510506
24483;2015/07/04 00:00:00.000;3;3;0;0.022188763;0.000547889
24484;2015/07/04 00:00:00.000;2;2;0;0.0110943815;0.0002739445
24485;2015/07/04 00:00:00.000;1;1;0;0.0031698233;0.0000782699
24485;2015/09/05 00:00:00.000;5;5;0;0.0159116585;0.0003776265
24486;2015/09/05 00:00:00.000;2;2;0;0.0429614779;0.0010195916
24486;2015/07/04 00:00:00.000;8;6;2;0.0459624376;0.001134913
24501;2015/07/04 00:00:00.000;67;72;-5;0.2789444488;0.0068877477
24502;2015/09/05 00:00:00.000;105;101;4;0.6125988512;0.0145386216
24502;2015/07/04 00:00:00.000;101;114;-13;0.4501149061;0.0111143202
24503;2015/09/05 00:00:00.000;76;69;7;0.405747291;0.0096294766
24503;2015/07/04 00:00:00.000;89;89;0;0.4802282273;0.0118578838
24504;2015/07/04 00:00:00.000;29;31;-2;0.1394722244;0.0034438739
24504;2015/09/05 00:00:00.000;30;26;4;0.0652377997;0.0015482688
24517;2015/07/04 00:00:00.000;15;15;0;0.0427926143;0.0010566431
24520;2015/09/05 00:00:00.000;5;3;2;0.0143204926;0.0003398639
24521;2015/09/05 00:00:00.000;33;22;11;0.1416137604;0.0033608762
24521;2015/07/04 00:00:00.000;31;31;0;0.0966796101;0.0023872307
24522;2015/07/04 00:00:00.000;21;26;-5;0.0855852286;0.0021132862
24522;2015/09/05 00:00:00.000;31;12;19;0.052508473;0.0012461676
24523;2015/09/05 00:00:00.000;42;45;-3;0.2784540233;0.0066084643
24523;2015/07/04 00:00:00.000;51;53;-2;0.2662651557;0.0065746683
24526;2015/07/04 00:00:00.000;3;3;0;0.0110943815;0.0002739445
24527;2015/09/05 00:00:00.000;3;3;0;0.0015308309;0.000036346
24528;2015/09/05 00:00:00.000;8;7;1;0.0063646634;0.0001510506
24528;2015/07/04 00:00:00.000;6;7;-1;0.0095094698;0.0002348096
24529;2015/09/05 00:00:00.000;2;2;0;0.0127293268;0.0003021012
24529;2015/07/04 00:00:00.000;8;8;0;0.0253585863;0.0006261589
24530;2015/07/04 00:00:00.000;7;7;0;0.0095094698;0.0002348096
24530;2015/09/05 00:00:00.000;4;4;0;0.0031823317;0.0000755253
24531;2015/07/04 00:00:00.000;19;21;-2;0.061811554;0.0015262623
24534;2015/09/05 00:00:00.000;7;7;0;0.0047734975;0.000113288
24536;2015/07/04 00:00:00.000;1;1;0;0.0031698233;0.0000782699
24538;2015/07/04 00:00:00.000;9;9;0;0.0602266424;0.0014871273
24538;2015/09/05 00:00:00.000;11;8;3;0.0365968145;0.000868541
24540;2015/07/04 00:00:00.000;78;75;3;0.1996988668;0.0049310012
24540;2015/09/05 00:00:00.000;153;175;-22;0.2848186867;0.006759515
24541;2015/09/05 00:00:00.000;215;227;-12;0.3532388181;0.0083833091
24541;2015/07/04 00:00:00.000;78;77;1;0.1996988668;0.0049310012
24549;2015/07/04 00:00:00.000;10;11;-1;0.0079245582;0.0001956747
24549;2015/09/05 00:00:00.000;18;22;-4;0.0970611167;0.0023035219
24550;2015/07/04 00:00:00.000;9;8;1;0.0523020842;0.0012914527
24551;2015/09/05 00:00:00.000;67;75;-8;0.3659681449;0.0086854103
24551;2015/07/04 00:00:00.000;91;96;-5;0.3914731754;0.0096663278
24553;2015/07/04 00:00:00.000;3;3;0;0.0190189397;0.0004696192
24553;2015/09/05 00:00:00.000;6;6;0;0.0143204926;0.0003398639
24555;2015/09/05 00:00:00.000;9;9;0;0.0222763219;0.0005286771
24555;2015/07/04 00:00:00.000;15;13;2;0.0079245582;0.0001956747
24556;2015/07/04 00:00:00.000;7;8;-1;0.022188763;0.000547889
24556;2015/09/05 00:00:00.000;10;7;3;0.0397791462;0.0009440663
24557;2015/07/04 00:00:00.000;12;8;4;0.0269434979;0.0006652938
24558;2015/09/05 00:00:00.000;22;23;-1;0.0286409852;0.0006797278
24558;2015/07/04 00:00:00.000;18;19;-1;0.044377526;0.001095778
24562;2015/07/04 00:00:00.000;3;2;1;0.0174340281;0.0004304842
24562;2015/09/05 00:00:00.000;2;2;0;0.0047734975;0.000113288
24563;2015/09/05 00:00:00.000;12;13;-1;0.020685156;0.0004909145
24563;2015/07/04 00:00:00.000;16;18;-2;0.0285284095;0.0007044287
24565;2015/09/05 00:00:00.000;4;5;-1;0.0076541547;0.0001817301
24566;2015/07/04 00:00:00.000;2;2;0;0.0015849116;0.0000391349
24569;2015/09/05 00:00:00.000;1;1;0;0.0031823317;0.0000755253
24571;2015/07/04 00:00:00.000;4;4;0;0.0237736746;0.000587024
24574;2015/09/05 00:00:00.000;11;12;-1;0.0334144828;0.0007930157
24574;2015/07/04 00:00:00.000;14;11;3;0.0427926143;0.0010566431
24577;2015/07/04 00:00:00.000;7;10;-3;0.0158491164;0.0003913493
24577;2015/09/05 00:00:00.000;3;4;-1;0.0270498194;0.0006419651
24578;2015/09/05 00:00:00.000;4;5;-1;0.0063646634;0.0001510506
24578;2015/07/04 00:00:00.000;4;5;-1;0.0031590087;0.000077787
24586;2015/07/04 00:00:00.000;9;9;0;0.0142642048;0.0003522144
24588;2015/07/04 00:00:00.000;21;26;-5;0.1172834614;0.0028959848
24588;2015/09/05 00:00:00.000;18;14;4;0.0795582924;0.0018881327
24589;2015/07/04 00:00:00.000;1;1;0;0.0079245582;0.0001956747
24589;2015/09/05 00:00:00.000;4;4;0;0.0030616619;0.000072692
24590;2015/07/04 00:00:00.000;35;33;2;0.0998494334;0.0024655006
24593;2015/07/04 00:00:00.000;5;6;-1;0.0015849116;0.0000391349
24593;2015/09/05 00:00:00.000;8;7;1;0.0063646634;0.0001510506
24594;2015/07/04 00:00:00.000;3;3;0;0.0047385131;0.0001166804
24594;2015/09/05 00:00:00.000;5;6;-1;0.0015911658;0.0000377627
24597;2015/09/05 00:00:00.000;4;4;0;0.0047734975;0.000113288
24598;2015/09/05 00:00:00.000;1;1;0;0.0153083094;0.0003634602
24599;2015/07/04 00:00:00.000;2;2;0;0.0142642048;0.0003522144
24602;2015/09/05 00:00:00.000;3;2;1;0.0015911658;0.0000377627
24602;2015/07/04 00:00:00.000;1;2;-1;0.0015849116;0.0000391349
24605;2015/07/04 00:00:00.000;17;33;-16;0.0903399635;0.002230691
24605;2015/09/05 00:00:00.000;18;18;0;0.0604643022;0.0014349808
24609;2015/09/05 00:00:00.000;9;9;0;0.0302321511;0.0007174904
24609;2015/07/04 00:00:00.000;8;7;1;0.0206038513;0.0005087541
24613;2015/07/04 00:00:00.000;1;2;-1;0.0015849116;0.0000391349
24613;2015/09/05 00:00:00.000;2;2;0;0.0015308309;0.000036346
24637;2015/07/04 00:00:00.000;6;7;-1;0.0190189397;0.0004696192
24641;2015/09/05 00:00:00.000;13;14;-1;0.062055468;0.0014727435
24641;2015/07/04 00:00:00.000;11;9;2;0.0633964656;0.0015653972
24649;2015/09/05 00:00:00.000;2;2;0;0.0015911658;0.0000377627
24651;2015/07/04 00:00:00.000;14;13;1;0.0475473492;0.0011740479
24651;2015/09/05 00:00:00.000;8;3;5;0.0190939902;0.0004531518
24656;2015/07/04 00:00:00.000;2;2;0;0.0015849116;0.0000391349
24701;2015/09/05 00:00:00.000;46;39;7;0.6464202952;0.0020014206
24701;2015/07/04 00:00:00.000;92;194;-102;1.3004605798;0.0037569533
24712;2015/07/04 00:00:00.000;2;3;-1;0.1625575725;0.0004696192
24712;2015/09/05 00:00:00.000;2;2;0;0.0731796561;0.0002265759
24736;2015/07/04 00:00:00.000;1;1;0;0.0812787862;0.0002348096
24736;2015/09/05 00:00:00.000;1;1;0;0.0116238521;0.000036346
24739;2015/09/05 00:00:00.000;20;19;1;0.5976338578;0.00185037
24739;2015/07/04 00:00:00.000;27;41;-14;0.4334868599;0.0012523178
24740;2015/09/05 00:00:00.000;28;30;-2;1.0854982315;0.0033608762
24747;2015/09/05 00:00:00.000;2;1;1;0.0487864374;0.0001510506
24747;2015/07/04 00:00:00.000;2;3;-1;0.0948252506;0.0002739445
24801;2015/09/05 00:00:00.000;6;6;0;0.1707525308;0.0005286771
24801;2015/07/04 00:00:00.000;4;4;0;0.0270929287;0.0000782699
24901;2015/09/05 00:00:00.000;22;21;1;0.3293084523;0.0010195916
24901;2015/07/04 00:00:00.000;16;18;-2;0.8398807911;0.0024263657
24910;2015/09/05 00:00:00.000;4;5;-1;0.1707525308;0.0005286771
24915;2015/07/04 00:00:00.000;2;2;0;0.0406393931;0.0001174048
24915;2015/09/05 00:00:00.000;5;5;0;0.1097694841;0.0003398639
24927;2015/09/05 00:00:00.000;2;2;0;0.0121966093;0.0000377627
24934;2015/09/05 00:00:00.000;2;2;0;0.036589828;0.000113288
24938;2015/09/05 00:00:00.000;1;1;0;0.0121966093;0.0000377627
24941;2015/09/05 00:00:00.000;28;24;4;0.036589828;0.000113288
24944;2015/09/05 00:00:00.000;6;6;0;0.1341627028;0.0004153892
24951;2015/07/04 00:00:00.000;1;1;0;0.0270929287;0.0000782699
24954;2015/07/04 00:00:00.000;8;8;0;0.3928474668;0.001134913
24957;2015/07/04 00:00:00.000;1;1;0;0.0135795763;0.0000388935
24963;2015/09/05 00:00:00.000;3;4;-1;0.0581192607;0.0001817301
24963;2015/07/04 00:00:00.000;2;2;0;0.0135464644;0.0000391349
24986;2015/09/05 00:00:00.000;11;8;3;0.4146847176;0.0012839302
24991;2015/07/04 00:00:00.000;1;1;0;0.0138831043;0.0000367031
25003;2015/07/04 00:00:00.000;2;2;0;0.108371715;0.0003130794
33351;2015/09/05 00:00:00.000;218;210;8;0.0799622819;0.0080056825
33401;2015/09/05 00:00:00.000;126;137;-11;0.1467232438;0.0146896722
33403;2015/09/05 00:00:00.000;56;31;25;0.0162187647;0.0016237941
33407;2015/09/05 00:00:00.000;218;236;-18;0.1365393682;0.0136700805
33408;2015/09/05 00:00:00.000;296;268;28;0.1346534653;0.0134812673
33409;2015/09/05 00:00:00.000;56;53;3;0.0671381424;0.0067217523
33410;2015/09/05 00:00:00.000;228;232;-4;0.1648279114;0.0165022795
33413;2015/09/05 00:00:00.000;64;74;-10;0.0403583215;0.0040406039
33414;2015/09/05 00:00:00.000;542;584;-42;0.2576143329;0.0257918923
33417;2015/09/05 00:00:00.000;91;87;4;0.1421970769;0.0142365203
33426;2015/09/05 00:00:00.000;70;77;-7;0.087883074;0.0087986982
33431;2015/09/05 00:00:00.000;51;45;6;0.1067421028;0.0106868309
33432;2015/09/05 00:00:00.000;111;109;2;0.1629420085;0.0163134663
33434;2015/09/05 00:00:00.000;107;125;-18;0.1701084394;0.0170309567
33435;2015/09/05 00:00:00.000;143;146;-3;0.1618104668;0.0162001783
33444;2015/09/05 00:00:00.000;32;40;-8;0.0897689769;0.0089875115
33460;2015/09/05 00:00:00.000;65;63;2;0.0788307402;0.0078923946
33469;2015/09/05 00:00:00.000;204;202;2;0.097689769;0.0097805272
33470;2015/09/05 00:00:00.000;66;70;-4;0.1090051862;0.0109134068
33473;2015/09/05 00:00:00.000;31;33;-2;0.0471475719;0.0047203317
33478;2015/09/05 00:00:00.000;63;55;8;0.0663837812;0.006646227
33480;2015/09/05 00:00:00.000;83;84;-1;0.1946251768;0.0194855292
33484;2015/09/05 00:00:00.000;102;112;-10;0.2025459689;0.0202785449
33486;2015/09/05 00:00:00.000;78;66;12;0.0837340877;0.0083833091
33493;2015/09/05 00:00:00.000;4;3;1;0.0067892504;0.0006797278
33496;2015/09/05 00:00:00.000;129;124;5;0.270815653;0.0271135852
33511;2015/09/05 00:00:00.000;110;103;7;0.198019802;0.019825393
33513;2015/09/05 00:00:00.000;14;16;-2;0.012446959;0.0012461676
33523;2015/09/05 00:00:00.000;168;166;2;0.0501650165;0.0050224329
33527;2015/09/05 00:00:00.000;19;18;1;0.0271570014;0.002718911
33534;2015/09/05 00:00:00.000;25;27;-2;0.0256482791;0.0025678604
33541;2015/09/05 00:00:00.000;93;99;-6;0.1048561999;0.0104980176
33542;2015/09/05 00:00:00.000;75;83;-8;0.0690240453;0.0069105656
33547;2015/09/05 00:00:00.000;104;108;-4;0.0901461575;0.0090252742
33548;2015/09/05 00:00:00.000;22;18;4;0.0222536539;0.0022279966
33556;2015/09/05 00:00:00.000;80;68;12;0.0746817539;0.0074770054
33558;2015/09/05 00:00:00.000;63;57;6;0.0505421971;0.0050601956
33565;2015/09/05 00:00:00.000;56;61;-5;0.0833569071;0.0083455464
33569;2015/09/05 00:00:00.000;68;79;-11;0.1037246582;0.0103847297
33570;2015/09/05 00:00:00.000;102;103;-1;0.1056105611;0.010573543
33584;2015/09/05 00:00:00.000;59;58;1;0.082602546;0.0082700211
33585;2015/09/05 00:00:00.000;1;1;0;0.0067892504;0.0006797278
33594;2015/09/05 00:00:00.000;96;92;4;0.1195662423;0.0119707611
33597;2015/09/05 00:00:00.000;14;14;0;0.0086751532;0.000868541
33598;2015/09/05 00:00:00.000;44;44;0;0.0358321546;0.0035874521
33604;2015/09/05 00:00:00.000;106;99;7;0.1357850071;0.0135945552
33605;2015/09/05 00:00:00.000;23;23;0;0.0531824611;0.0053245341
33609;2015/09/05 00:00:00.000;90;72;18;0.0984441301;0.0098560525
33612;2015/09/05 00:00:00.000;54;60;-6;0.1157944366;0.0115931346
33613;2015/09/05 00:00:00.000;47;47;0;0.0927864215;0.0092896127
33616;2015/09/05 00:00:00.000;40;47;-7;0.0859971711;0.008609885
33617;2015/09/05 00:00:00.000;294;246;48;0.1652050919;0.0165400422
33626;2015/09/05 00:00:00.000;99;95;4;0.2651579444;0.0265471454
33629;2015/09/05 00:00:00.000;143;130;13;0.167845356;0.0168043808
33634;2015/09/05 00:00:00.000;29;29;0;0.0694012258;0.0069483282
33647;2015/09/05 00:00:00.000;203;195;8;0.499009901;0.0499599905
33702;2015/09/05 00:00:00.000;64;69;-5;0.1301272984;0.0130281154
33703;2015/09/05 00:00:00.000;100;96;4;0.1406883545;0.0140854697
33706;2015/09/05 00:00:00.000;398;416;-18;0.2821310702;0.0282464648
33707;2015/09/05 00:00:00.000;612;516;96;0.1701084394;0.0170309567
33710;2015/09/05 00:00:00.000;89;85;4;0.2021687883;0.0202407822
33711;2015/09/05 00:00:00.000;88;74;14;0.1123998114;0.0112532707
33715;2015/09/05 00:00:00.000;116;111;5;0.1395568128;0.0139721818
33716;2015/09/05 00:00:00.000;12;13;-1;0.0407355021;0.0040783666
33763;2015/09/05 00:00:00.000;62;57;5;0.2100895804;0.021033798
33764;2015/09/05 00:00:00.000;89;95;-6;0.2025459689;0.0202785449
33770;2015/09/05 00:00:00.000;264;228;36;0.1410655351;0.0141232324
33771;2015/09/05 00:00:00.000;60;68;-8;0.0901461575;0.0090252742
33776;2015/09/05 00:00:00.000;49;46;3;0.1059877416;0.0106113056
33786;2015/09/05 00:00:00.000;17;15;2;0.039981141;0.0040028413
33801;2015/09/05 00:00:00.000;44;55;-11;0.0746817539;0.0074770054
33805;2015/09/05 00:00:00.000;52;54;-2;0.0565770863;0.005664398
33811;2015/09/05 00:00:00.000;43;40;3;0.0803394625;0.0080434452
33812;2015/09/05 00:00:00.000;29;27;2;0.045261669;0.0045315184
33823;2015/09/05 00:00:00.000;79;89;-10;0.1225836869;0.0122728624
33834;2015/09/05 00:00:00.000;1;1;0;0.002640264;0.0002643386
33837;2015/09/05 00:00:00.000;117;147;-30;0.1222065064;0.0122350997
33838;2015/09/05 00:00:00.000;5;6;-1;0.0082979727;0.0008307784
33841;2015/09/05 00:00:00.000;5;6;-1;0.0049033475;0.0004909145
33849;2015/07/04 00:00:00.000;1;1;0;0.0011250577;0.0001174048
33849;2015/09/05 00:00:00.000;1;1;0;0.0007543612;0.0000755253
33850;2015/07/04 00:00:00.000;15;16;-1;0.0183759418;0.0019176116
33850;2015/09/05 00:00:00.000;15;15;0;0.0173503065;0.0017370821
33852;2015/09/05 00:00:00.000;52;59;-7;0.1056105611;0.010573543
33852;2015/07/04 00:00:00.000;52;57;-5;0.0746288247;0.0077878511
33853;2015/07/04 00:00:00.000;36;30;6;0.0258763262;0.0027003102
33853;2015/09/05 00:00:00.000;17;18;-1;0.0414898633;0.0041538919
33855;2015/07/04 00:00:00.000;1;1;0;0.0165008457;0.0017219369
33857;2015/07/04 00:00:00.000;5;5;0;0.006750346;0.0007044287
33857;2015/09/05 00:00:00.000;2;2;0;0.0041489863;0.0004153892
33859;2015/07/04 00:00:00.000;42;33;9;0.0206260571;0.0021524212
33859;2015/09/05 00:00:00.000;39;38;1;0.0252710985;0.0025300978
33860;2015/07/04 00:00:00.000;76;75;1;0.037501922;0.003913493
33860;2015/09/05 00:00:00.000;58;55;3;0.0520509194;0.0052112462
33868;2015/09/05 00:00:00.000;25;19;6;0.0173503065;0.0017370821
33868;2015/07/04 00:00:00.000;28;26;2;0.0423771718;0.0044222471
33870;2015/07/04 00:00:00.000;48;46;2;0.0783790169;0.0081792004
33872;2015/09/05 00:00:00.000;66;68;-2;0.0961810467;0.0096294766
33872;2015/07/04 00:00:00.000;91;88;3;0.0963799395;0.0100576771
33873;2015/09/05 00:00:00.000;17;19;-2;0.0147100424;0.0014727435
33873;2015/07/04 00:00:00.000;12;19;-7;0.0236262108;0.0024655006
33875;2015/09/05 00:00:00.000;30;33;-3;0.0682696841;0.0068350403
33876;2015/09/05 00:00:00.000;13;11;2;0.0365865158;0.0036629774
33876;2015/07/04 00:00:00.000;22;23;-1;0.0243762493;0.0025437705
33880;2015/09/05 00:00:00.000;66;67;-1;0.0867515323;0.0086854103
33881;2015/07/04 00:00:00.000;102;100;2;0.0986300548;0.0102924866
33881;2015/09/05 00:00:00.000;75;81;-6;0.0897689769;0.0089875115
33884;2015/09/05 00:00:00.000;101;105;-4;0.1603017445;0.0160491277
33884;2015/07/04 00:00:00.000;140;129;11;0.1788841678;0.0186673617
33890;2015/09/05 00:00:00.000;2;3;-1;0.0041489863;0.0004153892
33890;2015/07/04 00:00:00.000;5;5;0;0.0093754805;0.0009783733
33896;2015/09/05 00:00:00.000;226;242;-16;0.1142857143;0.011442084
33897;2015/07/04 00:00:00.000;129;138;-9;0.1743839372;0.0181977425
33897;2015/09/05 00:00:00.000;142;144;-2;0.1991513437;0.019938681
33898;2015/07/04 00:00:00.000;56;51;5;0.0468774025;0.0048918663
33898;2015/09/05 00:00:00.000;44;52;-8;0.0592173503;0.0059287366
33901;2015/09/05 00:00:00.000;62;48;14;0.1463460632;0.0146519095
33901;2015/07/04 00:00:00.000;48;70;-22;0.0888795551;0.0092749785
33903;2015/09/05 00:00:00.000;50;52;-2;0.0810938237;0.0081189705
33903;2015/07/04 00:00:00.000;75;94;-19;0.1230063041;0.0128362571
33904;2015/09/05 00:00:00.000;153;134;19;0.2942008487;0.0294548697
33904;2015/07/04 00:00:00.000;168;213;-45;0.2842645686;0.0296642771
33905;2015/07/04 00:00:00.000;69;97;-28;0.1800092255;0.0187847665
33905;2015/09/05 00:00:00.000;68;54;14;0.1659594531;0.0166155675
33907;2015/09/05 00:00:00.000;62;49;13;0.0909005186;0.0091007995
33908;2015/07/04 00:00:00.000;195;294;-99;0.2673887037;0.0279032052
33908;2015/09/05 00:00:00.000;176;141;35;0.3413484206;0.0341752013
33909;2015/07/04 00:00:00.000;86;103;-17;0.1758840141;0.0183542823
33909;2015/09/05 00:00:00.000;78;69;9;0.2134842056;0.0213736618
33912;2015/09/05 00:00:00.000;81;68;13;0.1448373409;0.0145008589
33913;2015/09/05 00:00:00.000;322;320;2;0.2297029703;0.0229974559
33914;2015/07/04 00:00:00.000;231;320;-89;0.4128961609;0.0430875581
33914;2015/09/05 00:00:00.000;208;183;25;0.4639321075;0.0464480637
33916;2015/09/05 00:00:00.000;51;40;11;0.090523338;0.0090630368
33917;2015/07/04 00:00:00.000;66;104;-38;0.1338818614;0.0139711701
33917;2015/09/05 00:00:00.000;73;59;14;0.1150400754;0.0115176093
33919;2015/09/05 00:00:00.000;136;110;26;0.2481848185;0.0248478259
33920;2015/09/05 00:00:00.000;20;15;5;0.0147100424;0.0014727435
33921;2015/09/05 00:00:00.000;6;8;-2;0.0199905705;0.0020014206
33921;2015/07/04 00:00:00.000;13;13;0;0.0131256727;0.0013697226
33922;2015/07/04 00:00:00.000;14;25;-11;0.0435022295;0.0045396519
33922;2015/09/05 00:00:00.000;21;20;1;0.0354549741;0.0035496894
33924;2015/07/04 00:00:00.000;18;59;-41;0.0243762493;0.0025437705
33924;2015/09/05 00:00:00.000;26;19;7;0.0475247525;0.0047580943
33928;2015/09/05 00:00:00.000;115;92;23;0.2180103725;0.0218268137
33931;2015/07/04 00:00:00.000;81;114;-33;0.155257957;0.0162018611
33936;2015/09/05 00:00:00.000;63;50;13;0.0999528524;0.0100071032
33946;2015/09/05 00:00:00.000;54;48;6;0.0554455446;0.0055511101
33947;2015/09/05 00:00:00.000;58;59;-1;0.0871287129;0.0087231729
33947;2015/07/04 00:00:00.000;62;58;4;0.0918797088;0.0095880579
33948;2015/07/04 00:00:00.000;65;64;1;0.1511327456;0.0157713769
33950;2015/09/05 00:00:00.000;95;97;-2;0.228194248;0.0228464053
33950;2015/07/04 00:00:00.000;129;125;4;0.148507611;0.0154974324
33952;2015/09/05 00:00:00.000;95;93;2;0.1946251768;0.0194855292
33953;2015/09/05 00:00:00.000;32;40;-8;0.0595945309;0.0059664992
33954;2015/09/05 00:00:00.000;30;31;-1;0.0584629892;0.0058532113
33955;2015/07/04 00:00:00.000;79;70;9;0.1320067653;0.0137754954
33955;2015/09/05 00:00:00.000;46;40;6;0.0984441301;0.0098560525
33956;2015/07/04 00:00:00.000;12;22;-10;0.0502525754;0.0052440806
33956;2015/09/05 00:00:00.000;10;9;1;0.0573314474;0.0057399233
33957;2015/09/05 00:00:00.000;59;49;10;0.1293729373;0.0129525901
33960;2015/07/04 00:00:00.000;2;2;0;0.0007500384;0.0000782699
33960;2015/09/05 00:00:00.000;2;2;0;0.002640264;0.0002643386
33966;2015/09/05 00:00:00.000;44;44;0;0.1082508251;0.0108378815
33967;2015/09/05 00:00:00.000;59;47;12;0.1097595474;0.0109889321
33971;2015/07/04 00:00:00.000;48;60;-12;0.1005051509;0.0104881613
33972;2015/09/05 00:00:00.000;29;22;7;0.0520509194;0.0052112462
33973;2015/09/05 00:00:00.000;5;3;2;0.0245167374;0.0024545725
33973;2015/07/04 00:00:00.000;12;17;-5;0.0258763262;0.0027003102
33974;2015/07/04 00:00:00.000;36;43;-7;0.0618781713;0.0064572635
33976;2015/09/05 00:00:00.000;33;29;4;0.0380952381;0.003814028
33981;2015/07/04 00:00:00.000;56;61;-5;0.1443823996;0.0150669481
33981;2015/09/05 00:00:00.000;49;39;10;0.1116454503;0.0111777454
33982;2015/07/04 00:00:00.000;28;31;-3;0.0543777869;0.0056745649
33982;2015/09/05 00:00:00.000;27;27;0;0.0614804338;0.0061553125
33990;2015/09/05 00:00:00.000;82;83;-1;0.1459688826;0.0146141469
33991;2015/07/04 00:00:00.000;120;159;-39;0.1901347444;0.0198414096
33991;2015/09/05 00:00:00.000;86;78;8;0.1633191891;0.0163512289
33993;2015/07/04 00:00:00.000;127;170;-43;0.2546380502;0.0265726176
34102;2015/07/04 00:00:00.000;93;100;-7;0.1950099943;0.0203501637
34103;2015/07/04 00:00:00.000;56;69;-13;0.1166309773;0.0121709633
34103;2015/09/05 00:00:00.000;39;34;5;0.1395568128;0.0139721818
34104;2015/09/05 00:00:00.000;53;48;5;0.1934936351;0.0193722412
34104;2015/07/04 00:00:00.000;75;73;2;0.1417572651;0.0147930036
34105;2015/07/04 00:00:00.000;91;92;-1;0.1230063041;0.0128362571
34108;2015/07/04 00:00:00.000;81;84;-3;0.1413822458;0.0147538687
34109;2015/07/04 00:00:00.000;112;115;-3;0.1357569575;0.0141668447
34110;2015/09/05 00:00:00.000;95;88;7;0.2214049976;0.0221666776
34112;2015/09/05 00:00:00.000;87;78;9;0.2364922207;0.0236771837
34114;2015/09/05 00:00:00.000;91;98;-7;0.1591702027;0.0159358397
34114;2015/07/04 00:00:00.000;206;196;10;0.2422624159;0.0252811649
34116;2015/09/05 00:00:00.000;36;36;0;0.0995756719;0.0099693405
34116;2015/07/04 00:00:00.000;42;40;2;0.117756035;0.0122883681
34119;2015/09/05 00:00:00.000;136;117;19;0.2515794437;0.0251876898
34120;2015/09/05 00:00:00.000;97;92;5;0.2512022631;0.0251499272
34120;2015/07/04 00:00:00.000;124;135;-11;0.2126358976;0.0221895054
34135;2015/09/05 00:00:00.000;144;138;6;0.3605846299;0.0361010967
34138;2015/09/05 00:00:00.000;2;3;-1;0.0003771806;0.0000377627
34139;2015/09/05 00:00:00.000;4;3;1;0.0064120698;0.0006419651
34142;2015/07/04 00:00:00.000;30;36;-6;0.0442522679;0.0046179218
34142;2015/09/05 00:00:00.000;30;38;-8;0.0516737388;0.0051734835
34201;2015/07/04 00:00:00.000;132;124;8;0.0266263646;0.00277858
34202;2015/09/05 00:00:00.000;316;296;20;0.1693540783;0.0169554314
34203;2015/09/05 00:00:00.000;82;70;12;0.213107025;0.0213358992
34205;2015/07/04 00:00:00.000;63;70;-7;0.1432573419;0.0149495433
34205;2015/09/05 00:00:00.000;50;43;7;0.1282413956;0.0128393022
34207;2015/07/04 00:00:00.000;65;66;-1;0.1372570344;0.0143233845
34208;2015/09/05 00:00:00.000;53;58;-5;0.1308816596;0.0131036407
34209;2015/09/05 00:00:00.000;100;86;14;0.2161244696;0.0216380004
34209;2015/07/04 00:00:00.000;162;155;7;0.2351370508;0.0245376012
34210;2015/07/04 00:00:00.000;102;97;5;0.1065054584;0.0111143202
34212;2015/07/04 00:00:00.000;183;173;10;0.1380070729;0.0144016543
34215;2015/07/04 00:00:00.000;5;7;-2;0.0018750961;0.0001956747
34215;2015/09/05 00:00:00.000;1;1;0;0.002640264;0.0002643386
34216;2015/09/05 00:00:00.000;8;7;1;0.0354549741;0.0035496894
34219;2015/07/04 00:00:00.000;103;83;20;0.0817541899;0.0085314148
34219;2015/09/05 00:00:00.000;136;142;-6;0.1112682697;0.0111399828
34221;2015/07/04 00:00:00.000;120;127;-7;0.1162559581;0.0121318284
34222;2015/09/05 00:00:00.000;33;38;-5;0.0365865158;0.0036629774
34222;2015/07/04 00:00:00.000;42;41;1;0.0345017682;0.0036004136
34223;2015/09/05 00:00:00.000;98;70;28;0.1614332862;0.0161624157
34223;2015/07/04 00:00:00.000;115;115;0;0.1785091486;0.0186282268
34224;2015/07/04 00:00:00.000;52;56;-4;0.0915046896;0.009548923
34228;2015/07/04 00:00:00.000;229;180;49;0.1758840141;0.0183542823
34229;2015/09/05 00:00:00.000;30;36;-6;0.0611032532;0.0061175499
34229;2015/07/04 00:00:00.000;92;82;10;0.0720036902;0.0075139066
34231;2015/07/04 00:00:00.000;134;125;9;0.2936400491;0.0306426503
34232;2015/07/04 00:00:00.000;74;73;1;0.2145109937;0.0223851801
34232;2015/09/05 00:00:00.000;64;65;-1;0.2123526638;0.0212603739
34233;2015/07/04 00:00:00.000;72;67;5;0.1455074573;0.0151843529
34233;2015/09/05 00:00:00.000;60;53;7;0.2112211221;0.0211470859
34236;2015/09/05 00:00:00.000;64;47;17;0.1697312588;0.016993194
34237;2015/09/05 00:00:00.000;19;27;-8;0.0773220179;0.007741344
34237;2015/07/04 00:00:00.000;27;29;-2;0.1020052278;0.010644701
34238;2015/07/04 00:00:00.000;147;130;17;0.1462574957;0.0152626228
34239;2015/09/05 00:00:00.000;58;52;6;0.1048561999;0.0104980176
34240;2015/07/04 00:00:00.000;198;180;18;0.1083805545;0.0113099948
34240;2015/09/05 00:00:00.000;37;39;-2;0.0954266855;0.0095539513
34241;2015/07/04 00:00:00.000;68;52;16;0.1203811695;0.0125623126
34243;2015/09/05 00:00:00.000;84;61;23;0.2383781235;0.023865997
34250;2015/07/04 00:00:00.000;2;2;0;0.0011250577;0.0001174048
34250;2015/09/05 00:00:00.000;1;1;0;0.0022630835;0.0002265759
34251;2015/07/04 00:00:00.000;22;15;7;0.0247512685;0.0025829054
34269;2015/07/04 00:00:00.000;54;56;-2;0.0142507303;0.0014871273
34275;2015/09/05 00:00:00.000;122;77;45;0.1474776049;0.0147651975
34275;2015/07/04 00:00:00.000;432;376;56;0.124506381;0.0129927968
34286;2015/07/04 00:00:00.000;43;44;-1;0.1001301317;0.0104490264
34287;2015/07/04 00:00:00.000;81;74;7;0.1878846291;0.0196066
34288;2015/09/05 00:00:00.000;31;28;3;0.095049505;0.0095161887
34289;2015/09/05 00:00:00.000;3;2;1;0.0297972654;0.0029832496
34289;2015/07/04 00:00:00.000;2;3;-1;0.0097504997;0.0010175082
34293;2015/09/05 00:00:00.000;110;109;1;0.4118811881;0.0412368175
34293;2015/07/04 00:00:00.000;167;158;9;0.4245217567;0.044300741
34428;2015/07/04 00:00:00.000;31;35;-4;0.0600030752;0.0062615888
34428;2015/09/05 00:00:00.000;34;27;7;0.0524281;0.0052490088
34429;2015/07/04 00:00:00.000;58;62;-4;0.1008801701;0.0105272962
34431;2015/09/05 00:00:00.000;25;21;4;0.0380952381;0.003814028
34431;2015/07/04 00:00:00.000;25;27;-2;0.0352518067;0.0036786834
34432;2015/07/04 00:00:00.000;61;69;-8;0.0855043821;0.0089227641
34436;2015/09/05 00:00:00.000;36;36;0;0.0471475719;0.0047203317
34436;2015/07/04 00:00:00.000;21;25;-4;0.018750961;0.0019567465
34442;2015/09/05 00:00:00.000;82;72;10;0.0890146157;0.0089119862
34442;2015/07/04 00:00:00.000;68;68;0;0.1031302854;0.0107621058
34448;2015/07/04 00:00:00.000;46;52;-6;0.1095056122;0.0114273996
34448;2015/09/05 00:00:00.000;56;53;3;0.1123998114;0.0112532707
34449;2015/09/05 00:00:00.000;16;11;5;0.0162187647;0.0016237941
34452;2015/07/04 00:00:00.000;42;42;0;0.0345017682;0.0036004136
34452;2015/09/05 00:00:00.000;35;37;-2;0.0716643093;0.0071749041
34461;2015/09/05 00:00:00.000;46;41;5;0.0463932107;0.0046448064
34465;2015/07/04 00:00:00.000;68;65;3;0.1098806314;0.0114665345
34470;2015/09/05 00:00:00.000;47;42;5;0.0486562942;0.0048713823
34471;2015/09/05 00:00:00.000;85;75;10;0.112776992;0.0112910334
34473;2015/07/04 00:00:00.000;46;44;2;0.0491275178;0.0051266759
34474;2015/09/05 00:00:00.000;24;31;-7;0.0414898633;0.0041538919
34474;2015/07/04 00:00:00.000;29;29;0;0.040877095;0.0042657074
34475;2015/09/05 00:00:00.000;16;12;4;0.0196133899;0.001963658
34476;2015/07/04 00:00:00.000;68;76;-8;0.1278815539;0.0133450112
34479;2015/09/05 00:00:00.000;25;19;6;0.039981141;0.0040028413
34480;2015/09/05 00:00:00.000;68;66;2;0.097689769;0.0097805272
34480;2015/07/04 00:00:00.000;50;55;-5;0.0862544205;0.0090010339
34481;2015/07/04 00:00:00.000;71;66;5;0.1166309773;0.0121709633
34482;2015/07/04 00:00:00.000;56;52;4;0.0693785557;0.0072399621
34482;2015/09/05 00:00:00.000;78;61;17;0.0776991985;0.0077791066
34488;2015/09/05 00:00:00.000;20;26;-6;0.0271570014;0.002718911
34488;2015/07/04 00:00:00.000;14;16;-2;0.0225011532;0.0023480958
34491;2015/09/05 00:00:00.000;97;91;6;0.1195662423;0.0119707611
34498;2015/07/04 00:00:00.000;8;8;0;0.0086254421;0.0009001034
34601;2015/07/04 00:00:00.000;71;68;3;0.0877544974;0.0091575737
34601;2015/09/05 00:00:00.000;56;51;5;0.0863743517;0.0086476476
34602;2015/09/05 00:00:00.000;26;29;-3;0.0392267798;0.003927316
34604;2015/09/05 00:00:00.000;27;25;2;0.0433757661;0.0043427051
34604;2015/07/04 00:00:00.000;140;178;-38;0.0401270565;0.0041874375
34607;2015/07/04 00:00:00.000;168;214;-46;0.0753788632;0.007866121
34607;2015/09/05 00:00:00.000;204;198;6;0.0558227251;0.0055888727
34608;2015/07/04 00:00:00.000;103;101;2;0.2073856285;0.0216416164
34608;2015/09/05 00:00:00.000;103;98;5;0.1618104668;0.0162001783
34610;2015/09/05 00:00:00.000;43;45;-2;0.0694012258;0.0069483282
34613;2015/07/04 00:00:00.000;274;322;-48;0.1035053046;0.0108012407
34614;2015/09/05 00:00:00.000;37;41;-4;0.0467703913;0.004682569
34637;2015/09/05 00:00:00.000;35;34;1;0.002640264;0.0002643386
34639;2015/07/04 00:00:00.000;98;92;6;0.0003757661;0.000042535
34652;2015/07/04 00:00:00.000;121;131;-10;0.1455074573;0.0151843529
34652;2015/09/05 00:00:00.000;123;102;21;0.2376237624;0.0237904717
34653;2015/07/04 00:00:00.000;144;151;-7;0.1702587258;0.0177672583
34653;2015/09/05 00:00:00.000;120;119;1;0.1535124941;0.0153693999
34655;2015/09/05 00:00:00.000;744;718;26;0.2202734559;0.0220533896
34655;2015/07/04 00:00:00.000;710;686;24;0.2306368201;0.0240679821
34667;2015/07/04 00:00:00.000;166;166;0;0.2253865511;0.023520093
34667;2015/09/05 00:00:00.000;144;140;4;0.2063177746;0.0206561714
34668;2015/07/04 00:00:00.000;193;186;7;0.2501378196;0.0261029984
34669;2015/09/05 00:00:00.000;41;39;2;0.0660066007;0.0066084643
34669;2015/07/04 00:00:00.000;41;46;-5;0.0678784788;0.0070834224
34677;2015/07/04 00:00:00.000;80;73;7;0.1170059966;0.0122100982
34677;2015/09/05 00:00:00.000;65;69;-4;0.1199434229;0.0120085238
34681;2015/07/04 00:00:00.000;8;6;2;0.0198760186;0.0020741513
34683;2015/09/05 00:00:00.000;98;104;-6;0.2202734559;0.0220533896
34684;2015/09/05 00:00:00.000;83;91;-8;0.1716171617;0.0171820073
34684;2015/07/04 00:00:00.000;115;177;-62;0.2250115318;0.0234809581
34685;2015/09/05 00:00:00.000;52;51;1;0.1044790193;0.010460255
34685;2015/07/04 00:00:00.000;75;75;0;0.1170059966;0.0122100982
34689;2015/09/05 00:00:00.000;113;109;4;0.2561056106;0.0256408417
34690;2015/09/05 00:00:00.000;28;26;2;0.0482791136;0.0048336196
34691;2015/07/04 00:00:00.000;83;75;8;0.1173810158;0.0122492332
34695;2015/09/05 00:00:00.000;51;47;4;0.2297029703;0.0229974559
34698;2015/07/04 00:00:00.000;126;121;5;0.3660187585;0.0381956919
34705;2015/07/04 00:00:00.000;10;8;2;0.0075003844;0.0007826986
34705;2015/09/05 00:00:00.000;11;11;0;0.0045261669;0.0004531518
34711;2015/09/05 00:00:00.000;196;180;16;0.2376237624;0.0237904717
34714;2015/07/04 00:00:00.000;57;50;7;0.1005051509;0.0104881613
34731;2015/09/05 00:00:00.000;31;37;-6;0.0429985856;0.0043049425
34731;2015/07/04 00:00:00.000;32;31;1;0.0270013838;0.002817715
34734;2015/07/04 00:00:00.000;15;15;0;0.0090004613;0.0009392383
34736;2015/07/04 00:00:00.000;71;68;3;0.0472524217;0.0049310012
34736;2015/09/05 00:00:00.000;61;66;-5;0.0354549741;0.0035496894
34737;2015/07/04 00:00:00.000;14;16;-2;0.0007197196;0.0000734062
34741;2015/07/04 00:00:00.000;73;73;0;0.1275065347;0.0133058763
34741;2015/09/05 00:00:00.000;76;67;9;0.145591702;0.0145763842
34743;2015/09/05 00:00:00.000;61;67;-6;0.130504479;0.0130658781
34744;2015/07/04 00:00:00.000;116;117;-1;0.2497628003;0.0260638635
34744;2015/09/05 00:00:00.000;108;118;-10;0.2119754833;0.0212226112
34746;2015/09/05 00:00:00.000;192;181;11;0.3243752947;0.0324758819
34747;2015/09/05 00:00:00.000;538;560;-22;0.3028760019;0.0303234107
34748;2015/07/04 00:00:00.000;124;137;-13;0.1200061503;0.0125231777
34748;2015/09/05 00:00:00.000;105;117;-12;0.0988213107;0.0098938152
34756;2015/07/04 00:00:00.000;10;8;2;0.0146257496;0.0015262623
34756;2015/09/05 00:00:00.000;14;13;1;0.0052805281;0.0005286771
34758;2015/07/04 00:00:00.000;107;103;4;0.2692637998;0.0280988799
34759;2015/09/05 00:00:00.000;220;190;30;0.1995285243;0.0199764437
34760;2015/09/05 00:00:00.000;3;4;-1;0.0003771806;0.0000377627
34760;2015/07/04 00:00:00.000;1;1;0;0.0041252114;0.0004304842
34761;2015/07/04 00:00:00.000;122;115;7;0.1005051509;0.0104881613
34769;2015/09/05 00:00:00.000;44;50;-6;0.0939179632;0.0094029007
34771;2015/07/04 00:00:00.000;80;81;-1;0.0855043821;0.0089227641
34772;2015/09/05 00:00:00.000;67;66;1;0.0875058934;0.0087609356
34773;2015/09/05 00:00:00.000;90;90;0;0.0267798208;0.0026811484
34785;2015/09/05 00:00:00.000;37;34;3;0.0445073079;0.0044559931
34787;2015/09/05 00:00:00.000;410;550;-140;0.2330975955;0.0233373198
34788;2015/07/04 00:00:00.000;66;59;7;0.0731287478;0.0076313114
34788;2015/09/05 00:00:00.000;48;48;0;0.0709099481;0.0070993788
34797;2015/09/05 00:00:00.000;5;5;0;0.0056577086;0.0005664398
34945;2015/09/05 00:00:00.000;9;7;2;0.0241395568;0.0024168098
34946;2015/07/04 00:00:00.000;9;9;0;0.0277514223;0.0028959848
34947;2015/07/04 00:00:00.000;11;12;-1;0.0161258264;0.001682802
34947;2015/09/05 00:00:00.000;14;12;2;0.0162187647;0.0016237941
34950;2015/07/04 00:00:00.000;27;25;2;0.030751576;0.0032090643
34950;2015/09/05 00:00:00.000;27;25;2;0.0463932107;0.0046448064
34951;2015/07/04 00:00:00.000;65;62;3;0.0900046127;0.0093923832
34951;2015/09/05 00:00:00.000;46;37;9;0.0761904762;0.007628056
34953;2015/09/05 00:00:00.000;155;148;7;0.4228194248;0.0423319345
34953;2015/07/04 00:00:00.000;145;150;-5;0.4323971604;0.0451225745
34957;2015/09/05 00:00:00.000;110;125;-15;0.2044318718;0.0204673582
34972;2015/07/04 00:00:00.000;12;16;-4;0.0255013069;0.0026611753
34974;2015/09/05 00:00:00.000;17;17;0;0.0554455446;0.0055511101
34981;2015/09/05 00:00:00.000;12;10;2;0.0181046676;0.0018126074
34981;2015/07/04 00:00:00.000;9;7;2;0.0101255189;0.0010566431
34982;2015/09/05 00:00:00.000;46;42;4;0.1025931165;0.0102714417
34984;2015/09/05 00:00:00.000;49;51;-2;0.1452145215;0.0145386216
34986;2015/07/04 00:00:00.000;162;161;1;0.2362621084;0.024655006
34990;2015/07/04 00:00:00.000;152;146;6;0.2415123775;0.025202895
34990;2015/09/05 00:00:00.000;129;123;6;0.2066949552;0.0206939341
34994;2015/09/05 00:00:00.000;51;48;3;0.0841112683;0.0084210717
34996;2015/07/04 00:00:00.000;206;258;-52;0.0960049203;0.0100185421
34997;2015/07/04 00:00:00.000;128;125;3;0.2583882424;0.0269639669
35004;2015/09/05 00:00:00.000;34;40;-6;0.3644740914;0.0040028413
35005;2015/09/05 00:00:00.000;35;40;-5;0.2166213939;0.0023790472
35006;2015/07/04 00:00:00.000;2;2;0;0.0236550419;0.0002739445
35007;2015/07/04 00:00:00.000;54;49;5;0.6555825899;0.0075921765
35010;2015/09/05 00:00:00.000;41;47;-6;0.2063060895;0.0022657592
35010;2015/07/04 00:00:00.000;24;21;3;0.2771019194;0.0032090643
35014;2015/09/05 00:00:00.000;10;12;-2;0.058453392;0.0006419651
35014;2015/07/04 00:00:00.000;6;6;0;0.0270343336;0.0003130794
35016;2015/07/04 00:00:00.000;60;56;4;0.2939983779;0.0034047389
35019;2015/07/04 00:00:00.000;2;2;0;0.0064092293;0.000077787
35019;2015/09/05 00:00:00.000;1;1;0;0.0034384348;0.0000377627
35020;2015/07/04 00:00:00.000;35;28;7;0.2196539605;0.0025437705
35020;2015/09/05 00:00:00.000;40;59;-19;0.1409758278;0.0015482688
35022;2015/07/04 00:00:00.000;256;256;0;0.5879967559;0.0068094779
35023;2015/07/04 00:00:00.000;74;76;-2;0.3751013788;0.0043439773
35031;2015/07/04 00:00:00.000;8;8;0;0.0439307921;0.0005087541
35031;2015/09/05 00:00:00.000;13;18;-5;0.0343843482;0.0003776265
35033;2015/07/04 00:00:00.000;2;3;-1;0.0304136253;0.0003522144
35034;2015/09/05 00:00:00.000;4;5;-1;0.0034384348;0.0000377627
35034;2015/07/04 00:00:00.000;2;3;-1;0.0101378751;0.0001174048
35040;2015/09/05 00:00:00.000;54;63;-9;0.2716363511;0.0029832496
35040;2015/07/04 00:00:00.000;63;58;5;0.395377129;0.0045787868
35042;2015/07/04 00:00:00.000;6;4;2;0.0067585834;0.0000782699
35043;2015/07/04 00:00:00.000;59;63;-4;0.2906190862;0.003365604
35044;2015/09/05 00:00:00.000;11;15;-4;0.0481380875;0.0005286771
35045;2015/09/05 00:00:00.000;46;60;-14;0.2681979163;0.002945487
35046;2015/07/04 00:00:00.000;16;13;3;0.0608272506;0.0007044287
35049;2015/09/05 00:00:00.000;6;10;-4;0.0206306089;0.0002265759
35053;2015/07/04 00:00:00.000;9;8;1;0.1757231684;0.0020350164
35053;2015/09/05 00:00:00.000;14;13;1;0.1031530447;0.0011328796
35054;2015/09/05 00:00:00.000;16;24;-8;0.1306605233;0.0014349808
35057;2015/07/04 00:00:00.000;22;24;-2;0.2061367937;0.0023872307
35061;2015/07/04 00:00:00.000;1;1;0;0.0067585834;0.0000782699
35063;2015/07/04 00:00:00.000;2;1;1;0.0033792917;0.0000391349
35064;2015/07/04 00:00:00.000;10;10;0;0.135171668;0.0015653972
35068;2015/07/04 00:00:00.000;61;54;7;0.2399297107;0.00277858
35072;2015/07/04 00:00:00.000;1;1;0;0.0288415318;0.0003500413
35073;2015/07/04 00:00:00.000;3;3;0;0.0270343336;0.0003130794
35078;2015/07/04 00:00:00.000;3;4;-1;0.0304136253;0.0003522144
35079;2015/07/04 00:00:00.000;24;20;4;0.0844822925;0.0009783733
35083;2015/07/04 00:00:00.000;4;4;0;0.0371722087;0.0004304842
35089;2015/07/04 00:00:00.000;2;2;0;0.0067585834;0.0000782699
35091;2015/07/04 00:00:00.000;20;26;-6;0.0439307921;0.0005087541
35098;2015/07/04 00:00:00.000;2;2;0;0.0033792917;0.0000391349
35114;2015/07/04 00:00:00.000;17;14;3;0.0439307921;0.0005087541
35117;2015/07/04 00:00:00.000;15;15;0;0.0844822925;0.0009783733
35118;2015/07/04 00:00:00.000;6;5;1;0.0067585834;0.0000782699
35120;2015/07/04 00:00:00.000;31;30;1;0.3751013788;0.0043439773
35121;2015/07/04 00:00:00.000;30;24;6;0.1959989186;0.002269826
35125;2015/07/04 00:00:00.000;15;17;-2;0.1486888348;0.0017219369
35126;2015/07/04 00:00:00.000;67;61;6;0.7197891322;0.0083357401
35130;2015/07/04 00:00:00.000;3;3;0;0.0067585834;0.0000782699
35131;2015/07/04 00:00:00.000;3;3;0;0.0270343336;0.0003130794
35135;2015/07/04 00:00:00.000;4;3;1;0.0304136253;0.0003522144
35136;2015/07/04 00:00:00.000;2;1;1;0.0135171668;0.0001565397
35143;2015/07/04 00:00:00.000;6;6;0;0.033792917;0.0003913493
44721;2015/09/05 00:00:00.000;45;35;10;0.1248726627;0.0028699617
44730;2015/09/05 00:00:00.000;26;26;0;0.0460057179;0.0010573543
44804;2015/09/05 00:00:00.000;2;1;1;0.0016430614;0.0000377627
44805;2015/09/05 00:00:00.000;61;54;7;0.1790936874;0.0041161292
44807;2015/09/05 00:00:00.000;1;1;0;0.0082153068;0.0001888133
44811;2015/09/05 00:00:00.000;32;35;-3;0.0394334724;0.0009063037
44813;2015/09/05 00:00:00.000;6;5;1;0.0525779633;0.0012084049
44814;2015/09/05 00:00:00.000;4;4;0;0.0082153068;0.0001888133
44817;2015/09/05 00:00:00.000;2;2;0;0.0131444908;0.0003021012
44818;2015/09/05 00:00:00.000;1;1;0;0.0032861227;0.0000755253
44820;2015/09/05 00:00:00.000;34;32;2;0.2842496139;0.006532939
44822;2015/09/05 00:00:00.000;6;5;1;0.0082153068;0.0001888133
44824;2015/09/05 00:00:00.000;2;2;0;0.0032861227;0.0000755253
44826;2015/09/05 00:00:00.000;2;1;1;0.0049291841;0.000113288
44827;2015/09/05 00:00:00.000;7;5;2;0.0345042884;0.0007930157
44830;2015/09/05 00:00:00.000;19;20;-1;0.0591502087;0.0013594555
44833;2015/09/05 00:00:00.000;32;22;10;0.0657224541;0.0015105061
44836;2015/09/05 00:00:00.000;1;1;0;0.0032861227;0.0000755253
44837;2015/09/05 00:00:00.000;6;7;-1;0.027932043;0.0006419651
44839;2015/09/05 00:00:00.000;31;25;6;0.0706516381;0.0016237941
44842;2015/09/05 00:00:00.000;15;10;5;0.0722946995;0.0016615568
44843;2015/09/05 00:00:00.000;7;6;1;0.0115014295;0.0002643386
44846;2015/09/05 00:00:00.000;5;4;1;0.055864086;0.0012839302
44847;2015/09/05 00:00:00.000;4;4;0;0.0065722454;0.0001510506
44849;2015/09/05 00:00:00.000;2;2;0;0.0082153068;0.0001888133
44851;2015/09/05 00:00:00.000;7;7;0;0.0197167362;0.0004531518
44854;2015/09/05 00:00:00.000;2;2;0;0.0016430614;0.0000377627
44857;2015/09/05 00:00:00.000;39;32;7;0.1413032763;0.0032475882
44859;2015/09/05 00:00:00.000;4;4;0;0.0065722454;0.0001510506
44866;2015/09/05 00:00:00.000;1;1;0;0.0049291841;0.000113288
44867;2015/09/05 00:00:00.000;2;2;0;0.0015836567;0.000036346
44880;2015/09/05 00:00:00.000;5;3;2;0.0032861227;0.0000755253
44883;2015/09/05 00:00:00.000;45;40;5;0.1807367487;0.0041538919
44890;2015/09/05 00:00:00.000;24;22;2;0.0427195951;0.000981829
44904;2015/09/05 00:00:00.000;128;122;6;0.1528047057;0.0035119268
44905;2015/09/05 00:00:00.000;14;13;1;0.0722946995;0.0016615568
44907;2015/09/05 00:00:00.000;30;28;2;0.0936544971;0.0021524712
45003;2015/09/05 00:00:00.000;1;1;0;0.0065722454;0.0001510506
45011;2015/09/05 00:00:00.000;520;580;-60;0.4584141172;0.0105357803
45013;2015/09/05 00:00:00.000;126;115;11;0.261246755;0.0060042619
45014;2015/09/05 00:00:00.000;69;69;0;0.2218132825;0.0050979582
45030;2015/09/05 00:00:00.000;49;53;-4;0.1758075647;0.0040406039
45039;2015/09/05 00:00:00.000;244;300;-56;0.2727481844;0.0062686005
45040;2015/09/05 00:00:00.000;124;168;-44;0.6966580132;0.016011365
45042;2015/09/05 00:00:00.000;69;66;3;0.1577338898;0.0036252147
45050;2015/09/05 00:00:00.000;20;20;0;0.06079327;0.0013972182
45054;2015/09/05 00:00:00.000;3;4;-1;0.0115014295;0.0002643386
45066;2015/09/05 00:00:00.000;57;58;-1;0.3433998225;0.0078923946
45067;2015/09/05 00:00:00.000;20;16;4;0.0262889816;0.0006042025
45101;2015/09/05 00:00:00.000;2;2;0;0.0065722454;0.0001510506
45102;2015/09/05 00:00:00.000;50;52;-2;0.0788669449;0.0018126074
45107;2015/09/05 00:00:00.000;11;15;-4;0.0525779633;0.0012084049
45113;2015/09/05 00:00:00.000;6;8;-2;0.0082153068;0.0001888133
45118;2015/09/05 00:00:00.000;15;19;-4;0.0312181657;0.0007174904
45122;2015/09/05 00:00:00.000;16;18;-2;0.0624363314;0.0014349808
45123;2015/09/05 00:00:00.000;11;7;4;0.1051559265;0.0024168098
45133;2015/09/05 00:00:00.000;91;92;-1;0.0969406198;0.0022279966
45135;2015/09/05 00:00:00.000;6;7;-1;0.0147875522;0.0003398639
45140;2015/09/05 00:00:00.000;125;132;-7;0.4337681969;0.0099693405
45142;2015/09/05 00:00:00.000;9;14;-5;0.0262889816;0.0006042025
45148;2015/09/05 00:00:00.000;3;3;0;0.0032861227;0.0000755253
45150;2015/09/05 00:00:00.000;61;64;-3;0.2481022641;0.0057021607
45152;2015/09/05 00:00:00.000;33;37;-4;0.1577338898;0.0036252147
45154;2015/09/05 00:00:00.000;12;16;-4;0.06079327;0.0013972182
45157;2015/09/05 00:00:00.000;20;23;-3;0.0377904111;0.000868541
45159;2015/09/05 00:00:00.000;4;5;-1;0.0147875522;0.0003398639
45162;2015/09/05 00:00:00.000;6;7;-1;0.0065722454;0.0001510506
45164;2015/09/05 00:00:00.000;1;1;0;0.0032861227;0.0000755253
45168;2015/09/05 00:00:00.000;5;5;0;0.0082153068;0.0001888133
45169;2015/09/05 00:00:00.000;14;17;-3;0.0262889816;0.0006042025
45171;2015/09/05 00:00:00.000;62;76;-14;0.0443626565;0.0010195916
45174;2015/09/05 00:00:00.000;6;11;-5;0.0312181657;0.0007174904
45177;2015/09/05 00:00:00.000;78;85;-7;0.172521442;0.0039650786
45202;2015/09/05 00:00:00.000;38;50;-12;0.2776773685;0.0063818884
45203;2015/09/05 00:00:00.000;1;2;-1;0.0098583681;0.0002265759
45204;2015/09/05 00:00:00.000;13;17;-4;0.0821530676;0.0018881327
45205;2015/09/05 00:00:00.000;23;23;0;0.0920114357;0.0021147086
45206;2015/09/05 00:00:00.000;23;38;-15;0.1380171536;0.0031720629
45207;2015/09/05 00:00:00.000;11;11;0;0.0624363314;0.0014349808
45208;2015/09/05 00:00:00.000;50;53;-3;0.3762610496;0.0086476476
45209;2015/09/05 00:00:00.000;7;8;-1;0.1396602149;0.0032098255
45211;2015/09/05 00:00:00.000;107;115;-8;0.2957510433;0.0067972776
45212;2015/09/05 00:00:00.000;106;120;-14;0.3433998225;0.0078923946
45213;2015/09/05 00:00:00.000;20;23;-3;0.1298018468;0.0029832496
45214;2015/09/05 00:00:00.000;3;3;0;0.0410765338;0.0009440663
45215;2015/09/05 00:00:00.000;184;224;-40;0.2218132825;0.0050979582
45216;2015/09/05 00:00:00.000;16;17;-1;0.1067989879;0.0024545725
45217;2015/09/05 00:00:00.000;15;17;-2;0.0443626565;0.0010195916
45218;2015/09/05 00:00:00.000;5;5;0;0.0180736749;0.0004153892
45219;2015/09/05 00:00:00.000;10;7;3;0.12158654;0.0027944364
45220;2015/09/05 00:00:00.000;12;18;-6;0.1281587854;0.002945487
45223;2015/09/05 00:00:00.000;22;22;0;0.1133712333;0.0026056231
45224;2015/09/05 00:00:00.000;34;41;-7;0.0969406198;0.0022279966
45225;2015/09/05 00:00:00.000;2;3;-1;0.0131444908;0.0003021012
45226;2015/09/05 00:00:00.000;19;20;-1;0.1593769511;0.0036629774
45227;2015/09/05 00:00:00.000;37;42;-5;0.1758075647;0.0040406039
45229;2015/09/05 00:00:00.000;8;10;-2;0.1117281719;0.0025678604
45230;2015/09/05 00:00:00.000;64;77;-13;0.3056094115;0.0070238535
45231;2015/09/05 00:00:00.000;95;97;-2;0.3433998225;0.0078923946
45232;2015/09/05 00:00:00.000;3;4;-1;0.0230028589;0.0005286771
45233;2015/09/05 00:00:00.000;41;40;1;0.1265157241;0.0029077243
45236;2015/09/05 00:00:00.000;114;116;-2;0.2842496139;0.006532939
45237;2015/09/05 00:00:00.000;40;52;-12;0.1659491965;0.003814028
45238;2015/09/05 00:00:00.000;130;136;-6;0.4633433012;0.0106490683
45239;2015/09/05 00:00:00.000;176;198;-22;0.1314449082;0.0030210123
45240;2015/09/05 00:00:00.000;30;36;-6;0.1626630738;0.0037385027
45241;2015/09/05 00:00:00.000;354;447;-93;0.1577338898;0.0036252147
45242;2015/09/05 00:00:00.000;270;386;-116;0.2300285893;0.0052867715
45243;2015/09/05 00:00:00.000;128;226;-98;0.2119549144;0.0048713823
45244;2015/09/05 00:00:00.000;63;83;-20;0.2070257303;0.0047580943
45247;2015/09/05 00:00:00.000;75;90;-15;0.1413032763;0.0032475882
45248;2015/09/05 00:00:00.000;82;86;-4;0.205382669;0.0047203317
45251;2015/09/05 00:00:00.000;59;63;-4;0.1018698038;0.0023412845
45252;2015/09/05 00:00:00.000;24;25;-1;0.0262889816;0.0006042025
45255;2015/09/05 00:00:00.000;106;122;-16;0.1363740922;0.0031343002
45303;2015/09/05 00:00:00.000;2;4;-2;0.0016430614;0.0000377627
45304;2015/09/05 00:00:00.000;12;16;-4;0.0295751043;0.0006797278
45306;2015/07/04 00:00:00.000;2;1;1;0.0016237984;0.0000388935
45306;2015/09/05 00:00:00.000;1;1;0;0.0049291841;0.000113288
45308;2015/09/05 00:00:00.000;8;13;-5;0.0164306135;0.0003776265
45308;2015/07/04 00:00:00.000;12;12;0;0.0064951936;0.0001555739
45309;2015/07/04 00:00:00.000;17;19;-2;0.0957494101;0.0021915561
45309;2015/09/05 00:00:00.000;17;22;-5;0.0262889816;0.0006042025
45311;2015/07/04 00:00:00.000;12;13;-1;0.0170981089;0.0003913493
45311;2015/09/05 00:00:00.000;8;13;-5;0.0443626565;0.0010195916
45312;2015/07/04 00:00:00.000;3;4;-1;0.0136784872;0.0003130794
45312;2015/09/05 00:00:00.000;3;3;0;0.0016430614;0.0000377627
45314;2015/07/04 00:00:00.000;1;1;0;0.0153882981;0.0003522144
45315;2015/09/05 00:00:00.000;46;62;-16;0.0295751043;0.0006797278
45315;2015/07/04 00:00:00.000;72;76;-4;0.0410354615;0.0009392383
45317;2015/09/05 00:00:00.000;1;1;0;0.0115014295;0.0002643386
45318;2015/07/04 00:00:00.000;5;4;1;0.0341962179;0.0007826986
45318;2015/09/05 00:00:00.000;8;10;-2;0.0230028589;0.0005286771
45319;2015/09/05 00:00:00.000;2;2;0;0.0018306971;0.000040721
45319;2015/07/04 00:00:00.000;2;2;0;0.0017098109;0.0000391349
45320;2015/07/04 00:00:00.000;70;68;2;0.0991690319;0.002269826
45320;2015/09/05 00:00:00.000;63;89;-26;0.0870822517;0.0020014206
45322;2015/09/05 00:00:00.000;84;83;1;0.1659491965;0.003814028
45322;2015/07/04 00:00:00.000;133;119;14;0.1726909004;0.0039526279
45323;2015/07/04 00:00:00.000;16;15;1;0.1042984646;0.0023872307
45323;2015/09/05 00:00:00.000;12;13;-1;0.0509349019;0.0011706423
45324;2015/09/05 00:00:00.000;65;73;-8;0.2628898163;0.0060420245
45324;2015/07/04 00:00:00.000;93;89;4;0.1453339261;0.0033264691
45325;2015/07/04 00:00:00.000;11;11;0;0.0102588654;0.0002348096
45325;2015/09/05 00:00:00.000;6;9;-3;0.0131444908;0.0003021012
45326;2015/09/05 00:00:00.000;1;2;-1;0.0049291841;0.000113288
45326;2015/07/04 00:00:00.000;8;6;2;0.0227331774;0.0005445087
45327;2015/07/04 00:00:00.000;15;15;0;0.0512943268;0.0011740479
45327;2015/09/05 00:00:00.000;19;20;-1;0.1150142946;0.0026433857
45328;2015/07/04 00:00:00.000;1;1;0;0.0016237984;0.0000388935
45330;2015/07/04 00:00:00.000;1;1;0;0.0048713952;0.0001166804
45331;2015/07/04 00:00:00.000;57;59;-2;0.0906199774;0.0020741513
45331;2015/09/05 00:00:00.000;32;31;1;0.177450626;0.0040783666
45334;2015/09/05 00:00:00.000;5;4;1;0.0049291841;0.000113288
45335;2015/07/04 00:00:00.000;9;9;0;0.032486407;0.0007435637
45335;2015/09/05 00:00:00.000;10;13;-3;0.0476487792;0.0010951169
45337;2015/07/04 00:00:00.000;2;2;0;0.0102588654;0.0002348096
45337;2015/09/05 00:00:00.000;2;2;0;0.0082153068;0.0001888133
45338;2015/07/04 00:00:00.000;11;11;0;0.0307765961;0.0007044287
45339;2015/07/04 00:00:00.000;4;4;0;0.0017098109;0.0000391349
45341;2015/09/05 00:00:00.000;5;5;0;0.0016430614;0.0000377627
45342;2015/07/04 00:00:00.000;105;112;-7;0.2804089868;0.0064181286
45344;2015/07/04 00:00:00.000;32;32;0;0.0530041377;0.0012131828
45344;2015/09/05 00:00:00.000;33;30;3;0.1002267425;0.0023035219
45345;2015/07/04 00:00:00.000;10;8;2;0.0461648942;0.0010566431
45346;2015/09/05 00:00:00.000;1;2;-1;0.0063346267;0.0001453841
45347;2015/09/05 00:00:00.000;10;18;-8;0.0082153068;0.0001888133
45347;2015/07/04 00:00:00.000;17;16;1;0.0051294327;0.0001174048
45356;2015/07/04 00:00:00.000;58;66;-8;0.1248161953;0.0028568499
45356;2015/09/05 00:00:00.000;55;55;0;0.1823798101;0.0041916545
45363;2015/07/04 00:00:00.000;2;2;0;0.0034196218;0.0000782699
45365;2015/07/04 00:00:00.000;90;90;0;0.2256950381;0.0051658108
45365;2015/09/05 00:00:00.000;50;58;-8;0.1067989879;0.0024545725
45368;2015/09/05 00:00:00.000;4;6;-2;0.0262889816;0.0006042025
45368;2015/07/04 00:00:00.000;7;8;-1;0.0119686763;0.0002739445
45369;2015/07/04 00:00:00.000;5;3;2;0.0410354615;0.0009392383
45370;2015/09/05 00:00:00.000;8;6;2;0.0230028589;0.0005286771
45371;2015/09/05 00:00:00.000;52;49;3;0.266175939;0.0061175499
45371;2015/07/04 00:00:00.000;58;51;7;0.2427931471;0.0055571601
45373;2015/07/04 00:00:00.000;105;98;7;0.4582293198;0.0104881613
45373;2015/09/05 00:00:00.000;99;103;-4;0.2891787979;0.006646227
45380;2015/07/04 00:00:00.000;4;4;0;0.0017098109;0.0000391349
45380;2015/09/05 00:00:00.000;1;1;0;0.0180736749;0.0004153892
45382;2015/09/05 00:00:00.000;3;4;-1;0.0079182833;0.0001817301
45383;2015/07/04 00:00:00.000;7;12;-5;0.0256471634;0.000587024
45383;2015/09/05 00:00:00.000;10;12;-2;0.0460057179;0.0010573543
45385;2015/07/04 00:00:00.000;116;124;-8;0.1863693875;0.0042657074
45387;2015/09/05 00:00:00.000;13;15;-2;0.0673655154;0.0015482688
45387;2015/07/04 00:00:00.000;17;18;-1;0.0290667852;0.0006652938
45390;2015/09/05 00:00:00.000;2;2;0;0.00475097;0.0001090381
45402;2015/09/05 00:00:00.000;14;17;-3;0.1117281719;0.0025678604
45402;2015/07/04 00:00:00.000;18;19;-1;0.0786513012;0.0018002068
45403;2015/09/05 00:00:00.000;27;34;-7;0.0690085768;0.0015860314
45404;2015/07/04 00:00:00.000;27;22;5;0.0478747051;0.001095778
45405;2015/07/04 00:00:00.000;36;38;-2;0.1077180864;0.0024655006
45405;2015/09/05 00:00:00.000;27;28;-1;0.2152410371;0.0049469076
45406;2015/09/05 00:00:00.000;28;29;-1;0.1462324603;0.0033608762
45409;2015/09/05 00:00:00.000;168;150;18;0.2218132825;0.0050979582
45410;2015/07/04 00:00:00.000;53;52;1;0.1607222241;0.0036786834
45414;2015/07/04 00:00:00.000;63;60;3;0.2513422016;0.0057528347
45415;2015/09/05 00:00:00.000;39;46;-7;0.1232296014;0.002832199
45415;2015/07/04 00:00:00.000;60;59;1;0.1966282529;0.004500517
45416;2015/09/05 00:00:00.000;14;10;4;0.0377904111;0.000868541
45416;2015/07/04 00:00:00.000;7;9;-2;0.0102588654;0.0002348096
45417;2015/07/04 00:00:00.000;41;42;-1;0.1453339261;0.0033264691
45419;2015/07/04 00:00:00.000;314;288;26;0.1983380638;0.0045396519
45419;2015/09/05 00:00:00.000;354;350;4;0.2809634912;0.0064574137
45420;2015/09/05 00:00:00.000;109;111;-2;0.1478755217;0.0033986388
45420;2015/07/04 00:00:00.000;87;86;1;0.2154361728;0.0049310012
45424;2015/07/04 00:00:00.000;242;239;3;0.569367028;0.0130319318
45429;2015/09/05 00:00:00.000;192;184;8;0.2579606323;0.0059287366
45430;2015/07/04 00:00:00.000;9;13;-4;0.082070923;0.0018784766
45431;2015/07/04 00:00:00.000;174;198;-24;0.2239852272;0.0051266759
45432;2015/07/04 00:00:00.000;122;108;14;0.1607222241;0.0036786834
45432;2015/09/05 00:00:00.000;78;68;10;0.2070257303;0.0047580943
45433;2015/07/04 00:00:00.000;1;1;0;0.0017098109;0.0000391349
45439;2015/09/05 00:00:00.000;140;140;0;0.0755808222;0.0017370821
45449;2015/07/04 00:00:00.000;186;200;-14;0.1744007113;0.0039917629
45458;2015/07/04 00:00:00.000;726;615;111;0.5950141914;0.0136189557
45459;2015/07/04 00:00:00.000;124;126;-2;0.504394214;0.0115448044
45459;2015/09/05 00:00:00.000;97;83;14;0.471558608;0.0108378815
45502;2015/07/04 00:00:00.000;23;29;-6;0.1402044934;0.0032090643
45503;2015/07/04 00:00:00.000;84;84;0;0.2103067401;0.0048135964
45504;2015/09/05 00:00:00.000;30;37;-7;0.1396602149;0.0032098255
45504;2015/07/04 00:00:00.000;39;48;-9;0.2496323907;0.0057136998
45505;2015/07/04 00:00:00.000;35;43;-8;0.0803611121;0.0018393417
45505;2015/09/05 00:00:00.000;38;40;-2;0.0985836811;0.0022657592
45601;2015/07/04 00:00:00.000;65;74;-9;0.5026844031;0.0115056695
45612;2015/07/04 00:00:00.000;5;6;-1;0.0427452724;0.0009783733
45612;2015/09/05 00:00:00.000;4;4;0;0.0197167362;0.0004531518
45613;2015/09/05 00:00:00.000;2;1;1;0.0126692533;0.0002907681
45614;2015/07/04 00:00:00.000;3;4;-1;0.0051294327;0.0001174048
45616;2015/09/05 00:00:00.000;2;2;0;0.0065722454;0.0001510506
45616;2015/07/04 00:00:00.000;1;1;0;0.0102588654;0.0002348096
45623;2015/07/04 00:00:00.000;2;2;0;0.0170981089;0.0003913493
45628;2015/09/05 00:00:00.000;14;11;3;0.027932043;0.0006419651
45629;2015/07/04 00:00:00.000;4;5;-1;0.0102588654;0.0002348096
45631;2015/09/05 00:00:00.000;19;15;4;0.0312181657;0.0007174904
45634;2015/07/04 00:00:00.000;1;1;0;0.0136784872;0.0003130794
45638;2015/07/04 00:00:00.000;64;74;-10;0.0478747051;0.001095778
45638;2015/09/05 00:00:00.000;70;58;12;0.0936544971;0.0021524712
45640;2015/09/05 00:00:00.000;22;10;12;0.0837961289;0.0019258953
45640;2015/07/04 00:00:00.000;16;13;3;0.0530041377;0.0012131828
45644;2015/07/04 00:00:00.000;4;2;2;0.0136784872;0.0003130794
45644;2015/09/05 00:00:00.000;4;3;1;0.0180736749;0.0004153892
45647;2015/07/04 00:00:00.000;3;3;0;0.0307765961;0.0007044287
45648;2015/09/05 00:00:00.000;9;12;-3;0.0312181657;0.0007174904
45650;2015/09/05 00:00:00.000;1;2;-1;0.0065722454;0.0001510506
45651;2015/07/04 00:00:00.000;3;3;0;0.0102588654;0.0002348096
45652;2015/09/05 00:00:00.000;3;3;0;0.027932043;0.0006419651
45652;2015/07/04 00:00:00.000;8;6;2;0.0102588654;0.0002348096
45653;2015/09/05 00:00:00.000;4;3;1;0.0312181657;0.0007174904
45654;2015/07/04 00:00:00.000;1;1;0;0.0097427903;0.0002333609
45656;2015/07/04 00:00:00.000;9;8;1;0.0085490545;0.0001956747
45658;2015/07/04 00:00:00.000;1;1;0;0.0016237984;0.0000388935
45658;2015/09/05 00:00:00.000;1;2;-1;0.0115014295;0.0002643386
45659;2015/07/04 00:00:00.000;1;1;0;0.0068392436;0.0001565397
45661;2015/09/05 00:00:00.000;4;2;2;0.0098583681;0.0002265759
45662;2015/09/05 00:00:00.000;102;120;-18;0.0542210246;0.0012461676
45662;2015/07/04 00:00:00.000;82;89;-7;0.0581335704;0.0013305876
45663;2015/07/04 00:00:00.000;9;9;0;0.0307765961;0.0007044287
45679;2015/07/04 00:00:00.000;7;6;1;0.0136784872;0.0003130794
45679;2015/09/05 00:00:00.000;5;5;0;0.0065722454;0.0001510506
45680;2015/09/05 00:00:00.000;15;9;6;0.0624363314;0.0014349808
45682;2015/07/04 00:00:00.000;1;1;0;0.0017098109;0.0000391349
45684;2015/09/05 00:00:00.000;5;4;1;0.0098583681;0.0002265759
45686;2015/09/05 00:00:00.000;1;1;0;0.0098583681;0.0002265759
45686;2015/07/04 00:00:00.000;2;2;0;0.0102588654;0.0002348096
45690;2015/07/04 00:00:00.000;4;4;0;0.0410354615;0.0009392383
45692;2015/09/05 00:00:00.000;51;26;25;0.0262889816;0.0006042025
45692;2015/07/04 00:00:00.000;14;15;-1;0.0102588654;0.0002348096
45693;2015/09/05 00:00:00.000;27;33;-6;0.0673655154;0.0015482688
45695;2015/09/05 00:00:00.000;1;1;0;0.0018306971;0.000040721
45695;2015/07/04 00:00:00.000;1;1;0;0.0016237984;0.0000388935
45696;2015/07/04 00:00:00.000;1;1;0;0.0032475968;0.000077787
45696;2015/09/05 00:00:00.000;1;1;0;0.0016430614;0.0000377627
45701;2015/09/05 00:00:00.000;17;19;-2;0.2760343071;0.0063441258
45711;2015/07/04 00:00:00.000;1;1;0;0.0051294327;0.0001174048
45715;2015/07/04 00:00:00.000;3;3;0;0.0017098109;0.0000391349
45723;2015/09/05 00:00:00.000;4;6;-2;0.0016430614;0.0000377627
45724;2015/07/04 00:00:00.000;2;2;0;0.0051294327;0.0001174048
45732;2015/07/04 00:00:00.000;5;5;0;0.0410354615;0.0009392383
45734;2015/07/04 00:00:00.000;1;1;0;0.0048713952;0.0001166804
45735;2015/09/05 00:00:00.000;2;2;0;0.0016430614;0.0000377627
45741;2015/07/04 00:00:00.000;1;1;0;0.0017098109;0.0000391349
45742;2015/09/05 00:00:00.000;2;2;0;0.0131444908;0.0003021012
45744;2015/09/05 00:00:00.000;1;1;0;0.0065722454;0.0001510506
45745;2015/07/04 00:00:00.000;1;1;0;0.0017098109;0.0000391349
45750;2015/09/05 00:00:00.000;36;32;4;0.1938812395;0.0044559931
45761;2015/07/04 00:00:00.000;1;1;0;0.0034196218;0.0000782699
45764;2015/07/04 00:00:00.000;3;2;1;0.0427452724;0.0009783733
45766;2015/09/05 00:00:00.000;1;1;0;0.0065722454;0.0001510506
45767;2015/09/05 00:00:00.000;1;2;-1;0.0098583681;0.0002265759
45769;2015/07/04 00:00:00.000;4;4;0;0.0307765961;0.0007044287
45771;2015/09/05 00:00:00.000;2;3;-1;0.00475097;0.0001090381
45772;2015/07/04 00:00:00.000;1;1;0;0.0051294327;0.0001174048
45778;2015/09/05 00:00:00.000;1;1;0;0.0016430614;0.0000377627
45780;2015/07/04 00:00:00.000;3;4;-1;0.0051294327;0.0001174048
45784;2015/09/05 00:00:00.000;4;4;0;0.0049291841;0.000113288
45784;2015/07/04 00:00:00.000;3;1;2;0.0085490545;0.0001956747
45786;2015/09/05 00:00:00.000;2;4;-2;0.0082153068;0.0001888133
45786;2015/07/04 00:00:00.000;2;3;-1;0.0222275416;0.0005087541
45788;2015/07/04 00:00:00.000;1;1;0;0.0047397858;0.0001101093
45804;2015/07/04 00:00:00.000;6;4;2;0.0239373525;0.000547889
45804;2015/09/05 00:00:00.000;6;6;0;0.0361473497;0.0008307784
45806;2015/07/04 00:00:00.000;6;6;0;0.032486407;0.0007435637
45807;2015/07/04 00:00:00.000;10;12;-2;0.0444550833;0.0010175082
45810;2015/07/04 00:00:00.000;3;4;-1;0.0119686763;0.0002739445
45812;2015/09/05 00:00:00.000;4;3;1;0.0016430614;0.0000377627
45813;2015/09/05 00:00:00.000;6;5;1;0.0049291841;0.000113288
45813;2015/07/04 00:00:00.000;5;5;0;0.0068392436;0.0001565397
45814;2015/07/04 00:00:00.000;7;6;1;0.0017098109;0.0000391349
45817;2015/07/04 00:00:00.000;4;4;0;0.0239373525;0.000547889
45817;2015/09/05 00:00:00.000;3;4;-1;0.0147875522;0.0003398639
45819;2015/07/04 00:00:00.000;2;2;0;0.0048713952;0.0001166804
45821;2015/09/05 00:00:00.000;1;1;0;0.0049291841;0.000113288
45822;2015/09/05 00:00:00.000;53;56;-3;0.0952975584;0.0021902339
45830;2015/09/05 00:00:00.000;1;1;0;0.0115014295;0.0002643386
45830;2015/07/04 00:00:00.000;2;2;0;0.0034196218;0.0000782699
45831;2015/09/05 00:00:00.000;2;1;1;0.0049291841;0.000113288
45831;2015/07/04 00:00:00.000;2;2;0;0.0102588654;0.0002348096
45833;2015/07/04 00:00:00.000;11;7;4;0.0273569743;0.0006261589
45836;2015/09/05 00:00:00.000;1;1;0;0.00475097;0.0001090381
45840;2015/07/04 00:00:00.000;112;115;-3;0.5197825121;0.0118970188
45840;2015/09/05 00:00:00.000;144;133;11;0.4617002399;0.0106113056
45841;2015/07/04 00:00:00.000;2;1;1;0.0034196218;0.0000782699
45845;2015/07/04 00:00:00.000;2;3;-1;0.0085490545;0.0001956747
45845;2015/09/05 00:00:00.000;1;1;0;0.0065722454;0.0001510506
45846;2015/09/05 00:00:00.000;1;1;0;0.0246459203;0.0005664398
45849;2015/07/04 00:00:00.000;1;1;0;0.0017098109;0.0000391349
45850;2015/09/05 00:00:00.000;2;2;0;0.0032861227;0.0000755253
45856;2015/09/05 00:00:00.000;8;7;1;0.0016430614;0.0000377627
45856;2015/07/04 00:00:00.000;1;3;-2;0.0034196218;0.0000782699
45862;2015/07/04 00:00:00.000;4;5;-1;0.0031598572;0.0000734062
45865;2015/09/05 00:00:00.000;1;1;0;0.0788669449;0.0018126074
45867;2015/07/04 00:00:00.000;1;1;0;0.0017098109;0.0000391349
45868;2015/09/05 00:00:00.000;1;1;0;0.0016430614;0.0000377627
45869;2015/09/05 00:00:00.000;3;3;0;0.0164306135;0.0003776265
45869;2015/07/04 00:00:00.000;3;6;-3;0.0239373525;0.000547889
45871;2015/09/05 00:00:00.000;2;2;0;0.0049291841;0.000113288
45872;2015/07/04 00:00:00.000;3;2;1;0.0034196218;0.0000782699
45872;2015/09/05 00:00:00.000;5;5;0;0.0098583681;0.0002265759
45873;2015/07/04 00:00:00.000;2;2;0;0.0102588654;0.0002348096
45875;2015/09/05 00:00:00.000;12;7;5;0.0180736749;0.0004153892
45875;2015/07/04 00:00:00.000;9;7;2;0.0205177307;0.0004696192
45879;2015/07/04 00:00:00.000;11;14;-3;0.0170981089;0.0003913493
45880;2015/09/05 00:00:00.000;3;4;-1;0.0016430614;0.0000377627
45880;2015/07/04 00:00:00.000;5;3;2;0.0017098109;0.0000391349
45881;2015/09/05 00:00:00.000;1;2;-1;0.0032861227;0.0000755253
45882;2015/07/04 00:00:00.000;3;5;-2;0.0068392436;0.0001565397
45885;2015/07/04 00:00:00.000;32;29;3;0.0376158397;0.0008609685
45885;2015/09/05 00:00:00.000;28;24;4;0.0197167362;0.0004531518
45889;2015/07/04 00:00:00.000;1;1;0;0.0188079198;0.0004304842
45889;2015/09/05 00:00:00.000;1;1;0;0.0082153068;0.0001888133
45891;2015/07/04 00:00:00.000;4;2;2;0.0341962179;0.0007826986
45895;2015/09/05 00:00:00.000;21;20;1;0.0706516381;0.0016237941
45895;2015/07/04 00:00:00.000;27;29;-2;0.0923297883;0.0021132862
45898;2015/07/04 00:00:00.000;3;3;0;0.0064951936;0.0001555739
46001;2015/09/05 00:00:00.000;21;22;-1;0.0788193406;0.0010951169
46011;2015/07/04 00:00:00.000;41;43;-2;0.140875596;0.0020350164
46012;2015/07/04 00:00:00.000;52;52;0;0.35218899;0.0050875409
46017;2015/07/04 00:00:00.000;36;38;-2;0.0866926745;0.0012523178
46030;2015/09/05 00:00:00.000;13;13;0;0.0407686245;0.0005664398
46031;2015/07/04 00:00:00.000;8;9;-1;0.0216731686;0.0003130794
46032;2015/07/04 00:00:00.000;150;150;0;1.1378413524;0.0164366707
46033;2015/09/05 00:00:00.000;115;101;14;0.7202456989;0.0100071032
46034;2015/09/05 00:00:00.000;34;28;6;0.0978446987;0.0013594555
46036;2015/09/05 00:00:00.000;24;22;2;0.054358166;0.0007552531
46036;2015/07/04 00:00:00.000;24;25;-1;0.0758560902;0.001095778
46037;2015/07/04 00:00:00.000;175;167;8;0.9780017339;0.0141277098
46037;2015/09/05 00:00:00.000;152;141;11;0.8642948387;0.0120085238
46040;2015/07/04 00:00:00.000;198;196;2;0.3278066753;0.0047353266
46040;2015/09/05 00:00:00.000;100;108;-8;0.3152773625;0.0043804678
46041;2015/09/05 00:00:00.000;21;16;5;0.1386133232;0.0019258953
46041;2015/07/04 00:00:00.000;23;22;1;0.1652579107;0.0023872307
46051;2015/07/04 00:00:00.000;5;5;0;0.0839835284;0.0012131828
46051;2015/09/05 00:00:00.000;2;2;0;0.0217432664;0.0003021012
46052;2015/07/04 00:00:00.000;55;53;2;0.2763328999;0.0039917629
46056;2015/09/05 00:00:00.000;5;5;0;0.0027179083;0.0000377627
46057;2015/09/05 00:00:00.000;1;1;0;0.0054358166;0.0000755253
46058;2015/07/04 00:00:00.000;4;3;1;0.0162548765;0.0002348096
46062;2015/09/05 00:00:00.000;378;314;64;0.584350284;0.0081189705
46064;2015/07/04 00:00:00.000;37;33;4;0.2600780234;0.0037569533
46065;2015/09/05 00:00:00.000;4;4;0;0.0298969913;0.0004153892
46068;2015/07/04 00:00:00.000;2;2;0;0.0406371912;0.000587024
46069;2015/07/04 00:00:00.000;10;11;-1;0.0839835284;0.0012131828
46069;2015/09/05 00:00:00.000;17;10;7;0.0489223494;0.0006797278
46070;2015/09/05 00:00:00.000;2;2;0;0.027179083;0.0003776265
46074;2015/09/05 00:00:00.000;410;388;22;0.6088114587;0.0084588344
46075;2015/07/04 00:00:00.000;46;50;-4;0.0975292588;0.0014088575
46075;2015/09/05 00:00:00.000;28;29;-1;0.154920773;0.0021524712
46076;2015/07/04 00:00:00.000;3;3;0;0.0027091461;0.0000391349
46104;2015/09/05 00:00:00.000;1;1;0;0.0244611747;0.0003398639
46105;2015/09/05 00:00:00.000;3;2;1;0.0027179083;0.0000377627
46106;2015/07/04 00:00:00.000;24;24;0;0.1625487646;0.0023480958
46107;2015/07/04 00:00:00.000;38;41;-3;0.1300390117;0.0018784766
46112;2015/09/05 00:00:00.000;101;96;5;0.4375832359;0.0060797872
46113;2015/07/04 00:00:00.000;37;32;5;0.1029475509;0.0014871273
46115;2015/09/05 00:00:00.000;5;6;-1;0.0217432664;0.0003021012
46120;2015/07/04 00:00:00.000;18;16;2;0.0975292588;0.0014088575
46121;2015/07/04 00:00:00.000;26;23;3;0.0677286519;0.0009783733
46121;2015/09/05 00:00:00.000;18;16;2;0.0570760743;0.0007930157
46122;2015/09/05 00:00:00.000;35;34;1;0.3343027206;0.0046448064
46126;2015/07/04 00:00:00.000;5;5;0;0.0108365843;0.0001565397
46126;2015/09/05 00:00:00.000;5;2;3;0.0489223494;0.0006797278
46130;2015/07/04 00:00:00.000;7;8;-1;0.0189640225;0.0002739445
46130;2015/09/05 00:00:00.000;6;6;0;0.0135895415;0.0001888133
46131;2015/07/04 00:00:00.000;64;55;9;0.6014304291;0.0086879545
46131;2015/09/05 00:00:00.000;60;57;3;0.5816323757;0.0080812078
46140;2015/09/05 00:00:00.000;104;98;6;0.4783518604;0.006646227
46140;2015/07/04 00:00:00.000;101;95;6;0.4117902037;0.0059485094
46142;2015/09/05 00:00:00.000;83;74;9;0.51096676;0.0070993788
46142;2015/07/04 00:00:00.000;87;82;5;0.8723450368;0.0126014475
46147;2015/09/05 00:00:00.000;6;5;1;0.0217432664;0.0003021012
46147;2015/07/04 00:00:00.000;17;14;3;0.0568920676;0.0008218335
46149;2015/07/04 00:00:00.000;3;3;0;0.0108365843;0.0001565397
46157;2015/07/04 00:00:00.000;11;9;2;0.0460554833;0.0006652938
46158;2015/07/04 00:00:00.000;64;62;2;0.4307542263;0.0062224539
46161;2015/07/04 00:00:00.000;7;6;1;0.0216731686;0.0003130794
46164;2015/07/04 00:00:00.000;52;50;2;0.2302774166;0.0033264691
46165;2015/07/04 00:00:00.000;5;4;1;0.0270914608;0.0003913493
46166;2015/07/04 00:00:00.000;8;7;1;0.0406371912;0.000587024
46167;2015/07/04 00:00:00.000;18;18;0;0.0948201127;0.0013697226
46171;2015/07/04 00:00:00.000;4;3;1;0.0135457304;0.0001956747
46173;2015/07/04 00:00:00.000;22;19;3;0.0514737755;0.0007435637
46176;2015/07/04 00:00:00.000;45;50;-5;0.3007152146;0.0043439773
46180;2015/07/04 00:00:00.000;1;1;0;0.0025618691;0.0000388935
46182;2015/07/04 00:00:00.000;1;2;-1;0.0162548765;0.0002348096
46186;2015/07/04 00:00:00.000;7;8;-1;0.0054182922;0.0000782699
46202;2015/07/04 00:00:00.000;43;51;-8;0.5499566537;0.0079443908
46203;2015/07/04 00:00:00.000;97;89;8;0.9238188123;0.0133450112
46205;2015/07/04 00:00:00.000;97;88;9;0.8289986996;0.0119752886
46208;2015/07/04 00:00:00.000;78;69;9;0.528283485;0.0076313114
46214;2015/07/04 00:00:00.000;59;61;-2;0.3955353273;0.0057136998
55760;2015/09/05 00:00:00.000;21;15;6;0.0259681241;0.0003021012
55760;2015/07/04 00:00:00.000;4;5;-1;0.0457680866;0.000547889
55763;2015/07/04 00:00:00.000;2;2;0;0.0098074471;0.0001174048
55763;2015/09/05 00:00:00.000;3;3;0;0.0292141396;0.0003398639
55765;2015/09/05 00:00:00.000;3;4;-1;0.0259681241;0.0003021012
55765;2015/07/04 00:00:00.000;1;1;0;0.0263956711;0.0003111478
55767;2015/07/04 00:00:00.000;8;10;-2;0.0588446827;0.0007044287
55767;2015/09/05 00:00:00.000;6;7;-1;0.0616742948;0.0007174904
55768;2015/07/04 00:00:00.000;6;5;1;0.0065382981;0.0000782699
55768;2015/09/05 00:00:00.000;3;7;-4;0.0259681241;0.0003021012
55769;2015/07/04 00:00:00.000;10;7;3;0.0163457452;0.0001956747
55769;2015/09/05 00:00:00.000;9;8;1;0.0519362483;0.0006042025
55771;2015/09/05 00:00:00.000;8;9;-1;0.0194760931;0.0002265759
55771;2015/07/04 00:00:00.000;3;3;0;0.0261531923;0.0003130794
55775;2015/07/04 00:00:00.000;7;8;-1;0.0228840433;0.0002739445
55775;2015/09/05 00:00:00.000;5;4;1;0.0097380465;0.000113288
55779;2015/09/05 00:00:00.000;50;44;6;0.0357061707;0.0004153892
55779;2015/07/04 00:00:00.000;9;10;-1;0.0326914904;0.0003913493
55781;2015/09/05 00:00:00.000;6;6;0;0.0097380465;0.000113288
55781;2015/07/04 00:00:00.000;6;6;0;0.0098983767;0.0001166804
55783;2015/07/04 00:00:00.000;13;16;-3;0.0424989375;0.0005087541
55783;2015/09/05 00:00:00.000;14;14;0;0.0681663258;0.0007930157
55787;2015/09/05 00:00:00.000;1;1;0;0.0032460155;0.0000377627
55790;2015/07/04 00:00:00.000;9;10;-1;0.0392297885;0.0004696192
55792;2015/09/05 00:00:00.000;30;51;-21;0.0649203103;0.0007552531
55792;2015/07/04 00:00:00.000;46;55;-9;0.1307659616;0.0015653972
55793;2015/09/05 00:00:00.000;2;2;0;0.003936388;0.000040721
55795;2015/07/04 00:00:00.000;4;4;0;0.0359606394;0.0004304842
55795;2015/09/05 00:00:00.000;6;5;1;0.0714123414;0.0008307784
55797;2015/07/04 00:00:00.000;3;3;0;0.0163457452;0.0001956747
55797;2015/09/05 00:00:00.000;1;1;0;0.0032460155;0.0000377627
55798;2015/09/05 00:00:00.000;3;2;1;0.0032460155;0.0000377627
55802;2015/09/05 00:00:00.000;7;6;1;0.0616742948;0.0007174904
55802;2015/07/04 00:00:00.000;1;1;0;0.0621138318;0.0007435637
55803;2015/09/05 00:00:00.000;40;35;5;0.5745447463;0.0066839897
55803;2015/07/04 00:00:00.000;36;30;6;1.0690117362;0.0127971222
55804;2015/09/05 00:00:00.000;40;37;3;0.4933943584;0.0057399233
55804;2015/07/04 00:00:00.000;23;23;0;0.7551734284;0.0090401689
55805;2015/07/04 00:00:00.000;15;11;4;0.2321095819;0.00277858
55805;2015/09/05 00:00:00.000;18;18;0;0.2531892102;0.002945487
55806;2015/09/05 00:00:00.000;19;18;1;0.1850228844;0.0021524712
55806;2015/07/04 00:00:00.000;13;12;1;0.2321095819;0.00277858
55807;2015/07/04 00:00:00.000;23;22;1;0.3138383079;0.0037569533
55808;2015/09/05 00:00:00.000;15;15;0;0.1428246827;0.0016615568
55810;2015/09/05 00:00:00.000;141;144;-3;0.1915149154;0.0022279966
55810;2015/07/04 00:00:00.000;66;42;24;0.1928797934;0.0023089609
55811;2015/07/04 00:00:00.000;186;184;2;0.7486351303;0.008961899
55812;2015/09/05 00:00:00.000;9;12;-3;0.3375856137;0.003927316
55901;2015/09/05 00:00:00.000;69;70;-1;1.2367319116;0.014387571
55902;2015/07/04 00:00:00.000;58;67;-9;0.8990159861;0.0107621058
55904;2015/09/05 00:00:00.000;39;33;6;0.415489986;0.0048336196
55906;2015/09/05 00:00:00.000;34;37;-3;0.4414581102;0.0051357209
55906;2015/07/04 00:00:00.000;55;59;-4;0.4347968224;0.0052049457
55910;2015/09/05 00:00:00.000;1;1;0;0.0095047999;0.0001090381
55910;2015/07/04 00:00:00.000;4;4;0;0.003269149;0.0000391349
55912;2015/07/04 00:00:00.000;29;27;2;0.1896106443;0.002269826
55912;2015/09/05 00:00:00.000;23;22;1;0.1525627292;0.0017748447
55918;2015/09/05 00:00:00.000;2;2;0;0.0031682666;0.000036346
55919;2015/09/05 00:00:00.000;3;3;0;0.0097380465;0.000113288
55919;2015/07/04 00:00:00.000;1;1;0;0.0163457452;0.0001956747
55920;2015/09/05 00:00:00.000;14;14;0;0.107118512;0.0012461676
55920;2015/07/04 00:00:00.000;13;15;-2;0.0653829808;0.0007826986
55921;2015/07/04 00:00:00.000;5;3;2;0.0294223414;0.0003522144
55921;2015/09/05 00:00:00.000;4;4;0;0.0389521862;0.0004531518
55922;2015/07/04 00:00:00.000;1;1;0;0.0065382981;0.0000782699
55923;2015/09/05 00:00:00.000;3;2;1;0.0389521862;0.0004531518
55923;2015/07/04 00:00:00.000;3;4;-1;0.0261531923;0.0003130794
55924;2015/07/04 00:00:00.000;4;5;-1;0.0196148942;0.0002348096
55926;2015/07/04 00:00:00.000;1;1;0;0.0098074471;0.0001174048
55926;2015/09/05 00:00:00.000;1;1;0;0.0095047999;0.0001090381
55927;2015/09/05 00:00:00.000;10;9;1;0.0227221086;0.0002643386
55929;2015/09/05 00:00:00.000;2;2;0;0.0129840621;0.0001510506
55931;2015/09/05 00:00:00.000;1;1;0;0.0097380465;0.000113288
55931;2015/07/04 00:00:00.000;1;1;0;0.0079450205;0.00008507
55932;2015/07/04 00:00:00.000;5;4;1;0.0065382981;0.0000782699
55932;2015/09/05 00:00:00.000;2;2;0;0.0162300776;0.0001888133
55934;2015/07/04 00:00:00.000;2;2;0;0.0359606394;0.0004304842
55935;2015/09/05 00:00:00.000;1;1;0;0.006492031;0.0000755253
55939;2015/09/05 00:00:00.000;3;2;1;0.0126730666;0.0001453841
55940;2015/07/04 00:00:00.000;5;5;0;0.0130765962;0.0001565397
55940;2015/09/05 00:00:00.000;6;6;0;0.0389521862;0.0004531518
55943;2015/09/05 00:00:00.000;3;3;0;0.0908884344;0.0010573543
55943;2015/07/04 00:00:00.000;6;5;1;0.0261531923;0.0003130794
55946;2015/07/04 00:00:00.000;12;10;2;0.0261531923;0.0003130794
55946;2015/09/05 00:00:00.000;11;10;1;0.0292141396;0.0003398639
55947;2015/09/05 00:00:00.000;23;24;-1;0.1363326517;0.0015860314
55947;2015/07/04 00:00:00.000;14;16;-2;0.0621138318;0.0007435637
55951;2015/09/05 00:00:00.000;2;3;-1;0.0032460155;0.0000377627
55952;2015/09/05 00:00:00.000;6;7;-1;0.0357061707;0.0004153892
55954;2015/07/04 00:00:00.000;3;3;0;0.0392297885;0.0004696192
55954;2015/09/05 00:00:00.000;2;1;1;0.0032460155;0.0000377627
55956;2015/09/05 00:00:00.000;4;5;-1;0.0097380465;0.000113288
55957;2015/09/05 00:00:00.000;2;2;0;0.0032460155;0.0000377627
55957;2015/07/04 00:00:00.000;2;2;0;0.0130765962;0.0001565397
55959;2015/09/05 00:00:00.000;3;5;-2;0.006492031;0.0000755253
55959;2015/07/04 00:00:00.000;4;3;1;0.0228840433;0.0002739445
55960;2015/09/05 00:00:00.000;8;8;0;0.0389521862;0.0004531518
55962;2015/07/04 00:00:00.000;1;1;0;0.0164972944;0.0001944674
55963;2015/07/04 00:00:00.000;11;12;-1;0.078459577;0.0009392383
55963;2015/09/05 00:00:00.000;6;6;0;0.0519362483;0.0006042025
55964;2015/09/05 00:00:00.000;3;2;1;0.0129840621;0.0001510506
55968;2015/09/05 00:00:00.000;1;1;0;0.0032460155;0.0000377627
55969;2015/09/05 00:00:00.000;3;3;0;0.0348509331;0.0003998062
55971;2015/09/05 00:00:00.000;1;1;0;0.0746583569;0.000868541
55971;2015/07/04 00:00:00.000;8;7;1;0.0261531923;0.0003130794
55972;2015/09/05 00:00:00.000;17;12;5;0.0584282793;0.0006797278
55974;2015/07/04 00:00:00.000;3;3;0;0.003269149;0.0000391349
55974;2015/09/05 00:00:00.000;5;5;0;0.0253461331;0.0002907681
55975;2015/07/04 00:00:00.000;2;3;-1;0.0424989375;0.0005087541
55975;2015/09/05 00:00:00.000;5;5;0;0.0324601552;0.0003776265
55981;2015/07/04 00:00:00.000;4;4;0;0.078459577;0.0009392383
55982;2015/09/05 00:00:00.000;1;1;0;0.006492031;0.0000755253
55983;2015/09/05 00:00:00.000;2;2;0;0.0095047999;0.0001090381
55987;2015/09/05 00:00:00.000;60;39;21;0.3862758464;0.0044937558
55991;2015/09/05 00:00:00.000;2;2;0;0.0126730666;0.0001453841
55992;2015/09/05 00:00:00.000;9;9;0;0.0779043724;0.0009063037
56001;2015/09/05 00:00:00.000;82;85;-3;1.012756841;0.0117819479
56003;2015/07/04 00:00:00.000;21;21;0;0.2059563896;0.0024655006
56007;2015/09/05 00:00:00.000;46;45;1;0.6849092739;0.0079679199
56010;2015/07/04 00:00:00.000;2;2;0;0.0032994589;0.0000388935
56011;2015/07/04 00:00:00.000;29;31;-2;0.2255712838;0.0027003102
56013;2015/09/05 00:00:00.000;24;30;-6;0.0324601552;0.0003776265
56014;2015/07/04 00:00:00.000;1;1;0;0.003269149;0.0000391349
56016;2015/07/04 00:00:00.000;3;2;1;0.0294223414;0.0003522144
56021;2015/07/04 00:00:00.000;1;1;0;0.0065382981;0.0000782699
56024;2015/09/05 00:00:00.000;8;7;1;0.0454442172;0.0005286771
56024;2015/07/04 00:00:00.000;1;2;-1;0.0490372356;0.000587024
56025;2015/09/05 00:00:00.000;1;1;0;0.003936388;0.000040721
56028;2015/07/04 00:00:00.000;1;1;0;0.0196148942;0.0002348096
56028;2015/09/05 00:00:00.000;5;3;2;0.0227221086;0.0002643386
56031;2015/07/04 00:00:00.000;18;17;1;0.1569191539;0.0018784766
56032;2015/07/04 00:00:00.000;1;1;0;0.003269149;0.0000391349
56036;2015/07/04 00:00:00.000;1;1;0;0.0130765962;0.0001565397
56036;2015/09/05 00:00:00.000;3;3;0;0.0324601552;0.0003776265
56037;2015/09/05 00:00:00.000;1;1;0;0.0032460155;0.0000377627
56042;2015/09/05 00:00:00.000;1;1;0;0.006492031;0.0000755253
56042;2015/07/04 00:00:00.000;1;1;0;0.0098074471;0.0001174048
56045;2015/07/04 00:00:00.000;2;2;0;0.0163457452;0.0001956747
56046;2015/07/04 00:00:00.000;1;1;0;0.0065382981;0.0000782699
56050;2015/07/04 00:00:00.000;1;1;0;0.0130765962;0.0001565397
56051;2015/09/05 00:00:00.000;2;1;1;0.006492031;0.0000755253
56051;2015/07/04 00:00:00.000;1;1;0;0.003269149;0.0000391349
56052;2015/09/05 00:00:00.000;1;1;0;0.0063365333;0.000072692
56055;2015/07/04 00:00:00.000;11;8;3;0.1078819183;0.0012914527
56057;2015/09/05 00:00:00.000;10;8;2;0.0292141396;0.0003398639
56058;2015/07/04 00:00:00.000;21;21;0;0.0980744712;0.0011740479
56062;2015/09/05 00:00:00.000;1;1;0;0.006492031;0.0000755253
56063;2015/07/04 00:00:00.000;8;6;2;0.0882670241;0.0010566431
56065;2015/09/05 00:00:00.000;9;13;-4;0.0129840621;0.0001510506
56068;2015/07/04 00:00:00.000;4;3;1;0.0065382981;0.0000782699
56069;2015/07/04 00:00:00.000;6;7;-1;0.0163457452;0.0001956747
56071;2015/09/05 00:00:00.000;32;24;8;0.1298406206;0.0015105061
56072;2015/07/04 00:00:00.000;8;8;0;0.0326914904;0.0003913493
56073;2015/09/05 00:00:00.000;16;24;-8;0.0908884344;0.0010573543
56073;2015/07/04 00:00:00.000;20;20;0;0.1830723463;0.0021915561
56074;2015/09/05 00:00:00.000;1;1;0;0.0129840621;0.0001510506
56074;2015/07/04 00:00:00.000;1;2;-1;0.0163457452;0.0001956747
56080;2015/07/04 00:00:00.000;1;1;0;0.0065382981;0.0000782699
56080;2015/09/05 00:00:00.000;2;2;0;0.0227221086;0.0002643386
56081;2015/07/04 00:00:00.000;2;2;0;0.003269149;0.0000391349
56081;2015/09/05 00:00:00.000;3;4;-1;0.0129840621;0.0001510506
56082;2015/09/05 00:00:00.000;23;23;0;0.2044989775;0.0023790472
56085;2015/07/04 00:00:00.000;5;3;2;0.0098074471;0.0001174048
56085;2015/09/05 00:00:00.000;7;8;-1;0.0649203103;0.0007552531
56087;2015/09/05 00:00:00.000;5;4;1;0.0097380465;0.000113288
56088;2015/09/05 00:00:00.000;1;1;0;0.0292141396;0.0003398639
56090;2015/07/04 00:00:00.000;1;1;0;0.0065989178;0.000077787
56093;2015/07/04 00:00:00.000;31;24;7;0.1765340482;0.0021132862
56096;2015/09/05 00:00:00.000;6;8;-2;0.0746583569;0.000868541
56096;2015/07/04 00:00:00.000;11;8;3;0.0457680866;0.000547889
56097;2015/09/05 00:00:00.000;13;6;7;0.0324601552;0.0003776265
56098;2015/07/04 00:00:00.000;6;3;3;0.0065989178;0.000077787
56101;2015/09/05 00:00:00.000;1;1;0;0.006492031;0.0000755253
56101;2015/07/04 00:00:00.000;1;2;-1;0.0424989375;0.0005087541
56110;2015/09/05 00:00:00.000;1;1;0;0.0032460155;0.0000377627
56113;2015/09/05 00:00:00.000;1;1;0;0.0032460155;0.0000377627
56119;2015/07/04 00:00:00.000;3;2;1;0.0032994589;0.0000388935
56121;2015/09/05 00:00:00.000;3;4;-1;0.0032460155;0.0000377627
56123;2015/07/04 00:00:00.000;2;2;0;0.0065382981;0.0000782699
56128;2015/09/05 00:00:00.000;6;3;3;0.0129840621;0.0001510506
56137;2015/07/04 00:00:00.000;4;4;0;0.0098074471;0.0001174048
56143;2015/07/04 00:00:00.000;4;9;-5;0.0980744712;0.0011740479
56144;2015/09/05 00:00:00.000;1;1;0;0.006492031;0.0000755253
56150;2015/09/05 00:00:00.000;5;5;0;0.0454442172;0.0005286771
56151;2015/09/05 00:00:00.000;1;1;0;0.0031682666;0.000036346
56161;2015/09/05 00:00:00.000;2;1;1;0.0032460155;0.0000377627
56161;2015/07/04 00:00:00.000;1;1;0;0.0098074471;0.0001174048
56166;2015/07/04 00:00:00.000;1;1;0;0.003269149;0.0000391349
56166;2015/09/05 00:00:00.000;1;1;0;0.0032460155;0.0000377627
56172;2015/07/04 00:00:00.000;2;4;-2;0.0261531923;0.0003130794
56175;2015/09/05 00:00:00.000;20;12;8;0.006492031;0.0000755253
56175;2015/07/04 00:00:00.000;5;5;0;0.0163457452;0.0001956747
56176;2015/07/04 00:00:00.000;1;1;0;0.003269149;0.0000391349
56176;2015/09/05 00:00:00.000;4;2;2;0.0032460155;0.0000377627
56183;2015/09/05 00:00:00.000;6;3;3;0.0097380465;0.000113288
56201;2015/09/05 00:00:00.000;69;68;1;0.3732917843;0.0043427051
56208;2015/07/04 00:00:00.000;1;1;0;0.0065989178;0.000077787
56215;2015/09/05 00:00:00.000;15;6;9;0.0324601552;0.0003776265
56218;2015/07/04 00:00:00.000;1;1;0;0.003269149;0.0000391349
56220;2015/09/05 00:00:00.000;15;6;9;0.0097380465;0.000113288
56222;2015/07/04 00:00:00.000;1;1;0;0.003269149;0.0000391349
56225;2015/09/05 00:00:00.000;5;2;3;0.0032460155;0.0000377627
56225;2015/07/04 00:00:00.000;2;2;0;0.003269149;0.0000391349
56228;2015/09/05 00:00:00.000;1;1;0;0.0097380465;0.000113288
56229;2015/09/05 00:00:00.000;6;5;1;0.0158413332;0.0001817301
56229;2015/07/04 00:00:00.000;1;2;-1;0.0039725102;0.000042535
56230;2015/07/04 00:00:00.000;3;3;0;0.0065382981;0.0000782699
56232;2015/07/04 00:00:00.000;1;1;0;0.0230962122;0.0002722544
56239;2015/09/05 00:00:00.000;1;1;0;0.0031682666;0.000036346
56241;2015/07/04 00:00:00.000;4;4;0;0.003269149;0.0000391349
56243;2015/07/04 00:00:00.000;6;7;-1;0.0131978356;0.0001555739
56251;2015/07/04 00:00:00.000;3;3;0;0.003269149;0.0000391349
56252;2015/09/05 00:00:00.000;2;2;0;0.0032460155;0.0000377627
56253;2015/09/05 00:00:00.000;1;1;0;0.0129840621;0.0001510506
56256;2015/09/05 00:00:00.000;8;2;6;0.006492031;0.0000755253
56258;2015/07/04 00:00:00.000;8;9;-1;0.0523063846;0.0006261589
56262;2015/09/05 00:00:00.000;2;2;0;0.0063365333;0.000072692
56263;2015/07/04 00:00:00.000;1;1;0;0.0065382981;0.0000782699
56263;2015/09/05 00:00:00.000;3;2;1;0.0063365333;0.000072692
56264;2015/07/04 00:00:00.000;2;2;0;0.003269149;0.0000391349
56267;2015/09/05 00:00:00.000;4;4;0;0.0714123414;0.0008307784
56267;2015/07/04 00:00:00.000;2;2;0;0.003269149;0.0000391349
56270;2015/09/05 00:00:00.000;4;2;2;0.0126730666;0.0001453841
56270;2015/07/04 00:00:00.000;4;4;0;0.0065989178;0.000077787
56273;2015/09/05 00:00:00.000;18;11;7;0.0616742948;0.0007174904
56273;2015/07/04 00:00:00.000;4;5;-1;0.0457680866;0.000547889
56277;2015/07/04 00:00:00.000;2;2;0;0.0098074471;0.0001174048
56277;2015/09/05 00:00:00.000;5;11;-6;0.0097380465;0.000113288
56278;2015/09/05 00:00:00.000;13;4;9;0.0259681241;0.0003021012
56278;2015/07/04 00:00:00.000;3;4;-1;0.0098074471;0.0001174048
56281;2015/09/05 00:00:00.000;1;1;0;0.0032460155;0.0000377627
56281;2015/07/04 00:00:00.000;1;1;0;0.003269149;0.0000391349
56282;2015/09/05 00:00:00.000;3;3;0;0.0126730666;0.0001453841
56285;2015/07/04 00:00:00.000;1;1;0;0.003269149;0.0000391349
56288;2015/07/04 00:00:00.000;7;6;1;0.0621138318;0.0007435637
56289;2015/07/04 00:00:00.000;2;2;0;0.0196148942;0.0002348096
56289;2015/09/05 00:00:00.000;1;2;-1;0.0097380465;0.000113288
56301;2015/09/05 00:00:00.000;106;103;3;0.3505696757;0.0040783666
56301;2015/07/04 00:00:00.000;282;272;10;0.3497989473;0.0041874375
56303;2015/07/04 00:00:00.000;107;109;-2;0.3988361829;0.0047744615
56304;2015/07/04 00:00:00.000;52;48;4;0.2353787309;0.002817715
56307;2015/09/05 00:00:00.000;6;7;-1;0.0129840621;0.0001510506
56308;2015/09/05 00:00:00.000;73;71;2;0.6621871653;0.0077035813
56309;2015/07/04 00:00:00.000;4;2;2;0.0163457452;0.0001956747
56310;2015/09/05 00:00:00.000;9;9;0;0.0162300776;0.0001888133
56310;2015/07/04 00:00:00.000;11;11;0;0.0523063846;0.0006261589
56311;2015/09/05 00:00:00.000;1;1;0;0.0194760931;0.0002265759
56315;2015/09/05 00:00:00.000;2;2;0;0.0162300776;0.0001888133
56318;2015/09/05 00:00:00.000;2;2;0;0.0129840621;0.0001510506
56318;2015/07/04 00:00:00.000;4;5;-1;0.0228840433;0.0002739445
56319;2015/07/04 00:00:00.000;5;4;1;0.003269149;0.0000391349
56326;2015/09/05 00:00:00.000;4;4;0;0.006492031;0.0000755253
56327;2015/07/04 00:00:00.000;2;2;0;0.0065382981;0.0000782699
56327;2015/09/05 00:00:00.000;1;1;0;0.006492031;0.0000755253
56330;2015/07/04 00:00:00.000;5;4;1;0.0098074471;0.0001174048
56331;2015/09/05 00:00:00.000;5;5;0;0.0486902327;0.0005664398
56331;2015/07/04 00:00:00.000;2;2;0;0.0196148942;0.0002348096
56332;2015/09/05 00:00:00.000;6;5;1;0.0032460155;0.0000377627
56334;2015/09/05 00:00:00.000;10;10;0;0.0973804655;0.0011328796
56336;2015/07/04 00:00:00.000;4;3;1;0.0424989375;0.0005087541
56338;2015/09/05 00:00:00.000;8;5;3;0.006492031;0.0000755253
56339;2015/09/05 00:00:00.000;4;3;1;0.0194760931;0.0002265759
56340;2015/07/04 00:00:00.000;5;6;-1;0.0196148942;0.0002348096
56343;2015/09/05 00:00:00.000;2;2;0;0.0032460155;0.0000377627
56345;2015/07/04 00:00:00.000;31;32;-1;0.0621138318;0.0007435637
56347;2015/07/04 00:00:00.000;19;18;1;0.0098074471;0.0001174048
56347;2015/09/05 00:00:00.000;16;12;4;0.0194760931;0.0002265759
56349;2015/09/05 00:00:00.000;1;1;0;0.0158413332;0.0001817301
56349;2015/07/04 00:00:00.000;3;2;1;0.0065382981;0.0000782699
56353;2015/07/04 00:00:00.000;15;19;-4;0.0359606394;0.0004304842
56354;2015/09/05 00:00:00.000;7;6;1;0.0292141396;0.0003398639
56354;2015/07/04 00:00:00.000;5;5;0;0.0294223414;0.0003522144
56358;2015/07/04 00:00:00.000;5;5;0;0.0948053222;0.001134913
56358;2015/09/05 00:00:00.000;6;6;0;0.0584282793;0.0006797278
56359;2015/09/05 00:00:00.000;12;14;-2;0.0227221086;0.0002643386
56359;2015/07/04 00:00:00.000;10;8;2;0.0163457452;0.0001956747
56361;2015/07/04 00:00:00.000;6;8;-2;0.0130765962;0.0001565397
56362;2015/07/04 00:00:00.000;11;9;2;0.0555755337;0.0006652938
56362;2015/09/05 00:00:00.000;12;9;3;0.0843964034;0.000981829
56367;2015/07/04 00:00:00.000;28;27;1;0.0359606394;0.0004304842
56368;2015/09/05 00:00:00.000;17;15;2;0.0908884344;0.0010573543
56368;2015/07/04 00:00:00.000;13;14;-1;0.0653829808;0.0007826986
56373;2015/07/04 00:00:00.000;6;4;2;0.0130765962;0.0001565397
56374;2015/09/05 00:00:00.000;17;20;-3;0.1298406206;0.0015105061
56375;2015/09/05 00:00:00.000;1;1;0;0.0063365333;0.000072692
56377;2015/07/04 00:00:00.000;75;76;-1;0.1928797934;0.0023089609
56377;2015/09/05 00:00:00.000;56;57;-1;0.1103645275;0.0012839302
56378;2015/09/05 00:00:00.000;14;15;-1;0.0454442172;0.0005286771
56381;2015/07/04 00:00:00.000;10;7;3;0.0490372356;0.000587024
56381;2015/09/05 00:00:00.000;7;8;-1;0.0227221086;0.0002643386
56382;2015/09/05 00:00:00.000;1;1;0;0.0032460155;0.0000377627
56386;2015/07/04 00:00:00.000;2;2;0;0.0098074471;0.0001174048
56387;2015/09/05 00:00:00.000;26;30;-4;0.100626481;0.0011706423
56387;2015/07/04 00:00:00.000;23;19;4;0.0359606394;0.0004304842
56401;2015/09/05 00:00:00.000;111;104;7;0.5193624826;0.0060420245
56431;2015/09/05 00:00:00.000;49;46;3;0.1201025741;0.0013972182
56435;2015/09/05 00:00:00.000;14;11;3;0.0324601552;0.0003776265
56438;2015/09/05 00:00:00.000;6;8;-2;0.006492031;0.0000755253
56440;2015/09/05 00:00:00.000;2;2;0;0.006492031;0.0000755253
56443;2015/09/05 00:00:00.000;5;4;1;0.0227221086;0.0002643386
56444;2015/09/05 00:00:00.000;14;14;0;0.0292141396;0.0003398639
56447;2015/09/05 00:00:00.000;3;2;1;0.0194760931;0.0002265759
56448;2015/09/05 00:00:00.000;5;5;0;0.0194760931;0.0002265759
56452;2015/09/05 00:00:00.000;7;5;2;0.006492031;0.0000755253
56455;2015/09/05 00:00:00.000;20;24;-4;0.006492031;0.0000755253
56461;2015/09/05 00:00:00.000;8;7;1;0.0454442172;0.0005286771
56464;2015/09/05 00:00:00.000;4;5;-1;0.0162300776;0.0001888133
56465;2015/09/05 00:00:00.000;18;15;3;0.0389521862;0.0004531518
56467;2015/09/05 00:00:00.000;5;9;-4;0.0259681241;0.0003021012
56468;2015/09/05 00:00:00.000;158;138;20;0.1525627292;0.0017748447
56472;2015/09/05 00:00:00.000;188;188;0;0.2272210861;0.0026433857
56473;2015/09/05 00:00:00.000;15;12;3;0.0292141396;0.0003398639
56475;2015/09/05 00:00:00.000;3;4;-1;0.0129840621;0.0001510506
56477;2015/09/05 00:00:00.000;3;3;0;0.0032460155;0.0000377627
56481;2015/09/05 00:00:00.000;1;1;0;0.0032460155;0.0000377627
56482;2015/09/05 00:00:00.000;6;8;-2;0.0129840621;0.0001510506
56510;2015/09/05 00:00:00.000;7;6;1;0.006492031;0.0000755253
56514;2015/09/05 00:00:00.000;10;10;0;0.0162300776;0.0001888133
56521;2015/09/05 00:00:00.000;3;3;0;0.0032460155;0.0000377627
56531;2015/09/05 00:00:00.000;2;2;0;0.006492031;0.0000755253
56537;2015/09/05 00:00:00.000;32;34;-2;0.308371474;0.0035874521
56542;2015/09/05 00:00:00.000;3;2;1;0.0097380465;0.000113288
56549;2015/09/05 00:00:00.000;7;7;0;0.0292141396;0.0003398639
56550;2015/09/05 00:00:00.000;1;1;0;0.0032460155;0.0000377627
56554;2015/09/05 00:00:00.000;8;7;1;0.0162300776;0.0001888133
56560;2015/09/05 00:00:00.000;67;62;5;0.4641802188;0.0054000594
56567;2015/09/05 00:00:00.000;3;2;1;0.006492031;0.0000755253
56571;2015/09/05 00:00:00.000;3;2;1;0.0129840621;0.0001510506
56572;2015/09/05 00:00:00.000;13;11;2;0.1493167137;0.0017370821
56575;2015/09/05 00:00:00.000;2;2;0;0.0032460155;0.0000377627
66531;2015/07/04 00:00:00.000;2;2;0;0.0310776163;0.0001555739
66531;2015/09/05 00:00:00.000;2;3;-1;0.0230946882;0.000113288
66532;2015/09/05 00:00:00.000;1;1;0;0.0230946882;0.000113288
66533;2015/07/04 00:00:00.000;6;5;1;0.0251193168;0.0001174048
66533;2015/09/05 00:00:00.000;4;5;-1;0.0307929176;0.0001510506
66534;2015/07/04 00:00:00.000;2;1;1;0.0921041614;0.0004304842
66534;2015/09/05 00:00:00.000;1;2;-1;0.0769822941;0.0003776265
66535;2015/07/04 00:00:00.000;4;3;1;0.100477267;0.0004696192
66535;2015/09/05 00:00:00.000;6;5;1;0.0307929176;0.0001510506
66536;2015/09/05 00:00:00.000;2;2;0;0.0076982294;0.0000377627
66536;2015/07/04 00:00:00.000;2;3;-1;0.0167462112;0.0000782699
66537;2015/09/05 00:00:00.000;2;2;0;0.0153964588;0.0000755253
66537;2015/07/04 00:00:00.000;3;3;0;0.0502386335;0.0002348096
66538;2015/09/05 00:00:00.000;1;1;0;0.0230946882;0.000113288
66539;2015/09/05 00:00:00.000;4;2;2;0.1000769823;0.0004909145
66539;2015/07/04 00:00:00.000;1;1;0;0.0251193168;0.0001174048
66542;2015/09/05 00:00:00.000;9;10;-1;0.1308698999;0.0006419651
66542;2015/07/04 00:00:00.000;8;9;-1;0.0921041614;0.0004304842
66543;2015/07/04 00:00:00.000;3;3;0;0.0334924223;0.0001565397
66543;2015/09/05 00:00:00.000;2;3;-1;0.0846805235;0.0004153892
66546;2015/07/04 00:00:00.000;2;2;0;0.0502386335;0.0002348096
66547;2015/07/04 00:00:00.000;28;28;0;0.3098049066;0.0014479924
66547;2015/09/05 00:00:00.000;18;20;-2;0.1616628176;0.0007930157
66549;2015/07/04 00:00:00.000;2;2;0;0.0753579503;0.0003522144
66549;2015/09/05 00:00:00.000;2;2;0;0.0230946882;0.000113288
66550;2015/09/05 00:00:00.000;2;1;1;0.0147253718;0.000072692
66550;2015/07/04 00:00:00.000;1;1;0;0.0155388082;0.000077787
66554;2015/07/04 00:00:00.000;2;2;0;0.0083731056;0.0000391349
66554;2015/09/05 00:00:00.000;2;3;-1;0.0307929176;0.0001510506
66604;2015/07/04 00:00:00.000;81;70;11;0.5107594407;0.0023872307
66604;2015/09/05 00:00:00.000;80;83;-3;0.4234026174;0.0020769459
66605;2015/07/04 00:00:00.000;22;25;-3;0.1590890061;0.0007435637
66605;2015/09/05 00:00:00.000;44;40;4;0.415704388;0.0020391833
66606;2015/07/04 00:00:00.000;26;32;-6;0.1925814285;0.0009001034
66606;2015/09/05 00:00:00.000;46;50;-4;0.2309468822;0.0011328796
66607;2015/07/04 00:00:00.000;5;4;1;0.0753579503;0.0003522144
66607;2015/09/05 00:00:00.000;10;9;1;0.0307929176;0.0001510506
66608;2015/07/04 00:00:00.000;4;6;-2;0.0418655279;0.0001956747
66608;2015/09/05 00:00:00.000;6;7;-1;0.038491147;0.0001888133
66609;2015/07/04 00:00:00.000;7;7;0;0.0334924223;0.0001565397
66609;2015/09/05 00:00:00.000;12;12;0;0.0846805235;0.0004153892
66610;2015/09/05 00:00:00.000;36;39;-3;0.415704388;0.0020391833
66610;2015/07/04 00:00:00.000;30;27;3;0.9963995646;0.0046570567
66611;2015/09/05 00:00:00.000;40;37;3;0.038491147;0.0001888133
66611;2015/07/04 00:00:00.000;30;24;6;0.1507159005;0.0007044287
66612;2015/09/05 00:00:00.000;1;1;0;0.038491147;0.0001888133
66612;2015/07/04 00:00:00.000;2;2;0;0.0502386335;0.0002348096
66614;2015/09/05 00:00:00.000;77;77;0;0.6312548114;0.0030965376
66614;2015/07/04 00:00:00.000;52;48;4;0.6531022356;0.0030525246
66615;2015/09/05 00:00:00.000;7;4;3;0.1462663587;0.0007174904
66615;2015/07/04 00:00:00.000;4;7;-3;0.0502386335;0.0002348096
66616;2015/07/04 00:00:00.000;13;13;0;0.1255965838;0.000587024
66616;2015/09/05 00:00:00.000;16;14;2;0.1077752117;0.0005286771
66617;2015/07/04 00:00:00.000;12;12;0;0.1925814285;0.0009001034
66618;2015/07/04 00:00:00.000;10;10;0;0.5191325463;0.0024263657
66618;2015/09/05 00:00:00.000;22;19;3;0.4618937644;0.0022657592
66619;2015/09/05 00:00:00.000;4;2;2;0.038491147;0.0001888133
66619;2015/07/04 00:00:00.000;3;3;0;0.0753579503;0.0003522144
66710;2015/09/05 00:00:00.000;1;1;0;0.0230946882;0.000113288
66711;2015/07/04 00:00:00.000;1;1;0;0.0230361668;0.0001101093
66713;2015/07/04 00:00:00.000;11;10;1;0.0837310558;0.0003913493
66713;2015/09/05 00:00:00.000;3;4;-1;0.1539645881;0.0007552531
66720;2015/09/05 00:00:00.000;34;19;15;0.3695150115;0.0018126074
66725;2015/09/05 00:00:00.000;10;7;3;0.1000769823;0.0004909145
66725;2015/07/04 00:00:00.000;19;17;2;0.0586117391;0.0002739445
66733;2015/07/04 00:00:00.000;4;4;0;0.1255965838;0.000587024
66734;2015/07/04 00:00:00.000;1;2;-1;0.0077694041;0.0000388935
66735;2015/09/05 00:00:00.000;1;2;-1;0.0073626859;0.000036346
66736;2015/09/05 00:00:00.000;6;9;-3;0.0307929176;0.0001510506
66736;2015/07/04 00:00:00.000;2;2;0;0.0083731056;0.0000391349
66739;2015/09/05 00:00:00.000;5;5;0;0.0538876059;0.0002643386
66739;2015/07/04 00:00:00.000;1;1;0;0.0502386335;0.0002348096
66748;2015/07/04 00:00:00.000;5;5;0;0.0669848447;0.0003130794
66748;2015/09/05 00:00:00.000;3;3;0;0.038491147;0.0001888133
66753;2015/07/04 00:00:00.000;3;3;0;0.0543858286;0.0002722544
66757;2015/09/05 00:00:00.000;7;8;-1;0.0461893764;0.0002265759
66757;2015/07/04 00:00:00.000;4;4;0;0.0753579503;0.0003522144
66762;2015/07/04 00:00:00.000;38;32;6;0.6949677635;0.0032481992
66763;2015/09/05 00:00:00.000;3;5;-2;0.038491147;0.0001888133
66763;2015/07/04 00:00:00.000;3;3;0;0.1423427949;0.0006652938
66770;2015/09/05 00:00:00.000;2;1;1;0.0294507436;0.0001453841
66773;2015/07/04 00:00:00.000;1;1;0;0.0076787223;0.0000367031
66773;2015/09/05 00:00:00.000;1;1;0;0.0147253718;0.000072692
66777;2015/09/05 00:00:00.000;2;2;0;0.0220880577;0.0001090381
66777;2015/07/04 00:00:00.000;2;3;-1;0.0502386335;0.0002348096
66781;2015/07/04 00:00:00.000;3;5;-2;0.0310776163;0.0001555739
66781;2015/09/05 00:00:00.000;2;2;0;0.0957149168;0.0004724982
66801;2015/07/04 00:00:00.000;53;59;-6;0.6698484468;0.0031307944
66801;2015/09/05 00:00:00.000;56;57;-1;1.03926097;0.0050979582
66830;2015/07/04 00:00:00.000;1;1;0;0.0167462112;0.0000782699
66834;2015/07/04 00:00:00.000;1;1;0;0.0167462112;0.0000782699
66835;2015/09/05 00:00:00.000;3;2;1;0.0368134295;0.0001817301
66835;2015/07/04 00:00:00.000;3;3;0;0.0077694041;0.0000388935
66839;2015/09/05 00:00:00.000;18;12;6;0.4618937644;0.0022657592
66840;2015/09/05 00:00:00.000;1;1;0;0.0368134295;0.0001817301
66852;2015/07/04 00:00:00.000;2;2;0;0.0233082123;0.0001166804
66854;2015/09/05 00:00:00.000;2;2;0;0.0076982294;0.0000377627
66857;2015/07/04 00:00:00.000;1;1;0;0.0077694041;0.0000388935
66860;2015/07/04 00:00:00.000;3;3;0;0.0167462112;0.0000782699
66861;2015/07/04 00:00:00.000;5;6;-1;0.0502386335;0.0002348096
66869;2015/09/05 00:00:00.000;2;2;0;0.0294507436;0.0001453841
66869;2015/07/04 00:00:00.000;1;1;0;0.0083731056;0.0000391349
66871;2015/09/05 00:00:00.000;1;1;0;0.0307929176;0.0001510506
66872;2015/09/05 00:00:00.000;2;2;0;0.0073626859;0.000036346
66901;2015/07/04 00:00:00.000;10;16;-6;0.1172234782;0.000547889
66938;2015/07/04 00:00:00.000;1;1;0;0.093232849;0.0004667218
66956;2015/09/05 00:00:00.000;1;1;0;0.0073626859;0.000036346
66968;2015/07/04 00:00:00.000;1;1;0;0.0098658248;0.000042535
67001;2015/09/05 00:00:00.000;2;2;0;0.0538876059;0.0002643386
67002;2015/07/04 00:00:00.000;56;51;5;0.7786988194;0.0036395485
67003;2015/07/04 00:00:00.000;1;1;0;0.0167462112;0.0000782699
67003;2015/09/05 00:00:00.000;1;1;0;0.0153964588;0.0000755253
67005;2015/07/04 00:00:00.000;10;11;-1;0.343297329;0.0016045321
67010;2015/09/05 00:00:00.000;38;32;6;0.7698229407;0.0037762653
67013;2015/07/04 00:00:00.000;6;6;0;0.0753579503;0.0003522144
67013;2015/09/05 00:00:00.000;6;5;1;0.0461893764;0.0002265759
67016;2015/07/04 00:00:00.000;1;2;-1;0.0083731056;0.0000391349
67017;2015/07/04 00:00:00.000;6;7;-1;0.0334924223;0.0001565397
67017;2015/09/05 00:00:00.000;8;5;3;0.1000769823;0.0004909145
67019;2015/07/04 00:00:00.000;2;2;0;0.0233082123;0.0001166804
67020;2015/09/05 00:00:00.000;2;2;0;0.038491147;0.0001888133
67023;2015/09/05 00:00:00.000;1;1;0;0.0076982294;0.0000377627
67025;2015/07/04 00:00:00.000;4;2;2;0.0669848447;0.0003130794
67026;2015/09/05 00:00:00.000;11;9;2;0.1924557352;0.0009440663
67029;2015/07/04 00:00:00.000;1;1;0;0.0077694041;0.0000388935
67030;2015/07/04 00:00:00.000;1;2;-1;0.0837310558;0.0003913493
67031;2015/09/05 00:00:00.000;3;3;0;0.0846805235;0.0004153892
67037;2015/09/05 00:00:00.000;66;66;0;1.4010777521;0.0068728029
67042;2015/07/04 00:00:00.000;18;21;-3;0.3935359625;0.0018393417
67042;2015/09/05 00:00:00.000;42;40;2;0.2925327175;0.0014349808
67045;2015/09/05 00:00:00.000;3;6;-3;0.0692840647;0.0003398639
67050;2015/09/05 00:00:00.000;3;2;1;0.0230946882;0.000113288
67052;2015/07/04 00:00:00.000;18;19;-1;0.3600435401;0.001682802
67053;2015/07/04 00:00:00.000;1;1;0;0.0167462112;0.0000782699
67053;2015/09/05 00:00:00.000;1;1;0;0.0230946882;0.000113288
67058;2015/09/05 00:00:00.000;4;3;1;0.0441761154;0.0002180761
67060;2015/07/04 00:00:00.000;25;27;-2;0.4521477016;0.0021132862
67062;2015/09/05 00:00:00.000;4;4;0;0.0615858353;0.0003021012
67063;2015/09/05 00:00:00.000;6;4;2;0.0461893764;0.0002265759
67067;2015/09/05 00:00:00.000;4;3;1;0.1077752117;0.0005286771
67068;2015/07/04 00:00:00.000;9;6;3;0.1339696894;0.0006261589
67074;2015/07/04 00:00:00.000;5;5;0;0.0167462112;0.0000782699
67101;2015/07/04 00:00:00.000;19;19;0;0.4186552792;0.0019567465
67104;2015/07/04 00:00:00.000;1;1;0;0.0167462112;0.0000782699
67107;2015/07/04 00:00:00.000;2;2;0;0.0167462112;0.0000782699
67107;2015/09/05 00:00:00.000;6;8;-2;0.0461893764;0.0002265759
67108;2015/07/04 00:00:00.000;4;3;1;0.0418655279;0.0001956747
67110;2015/09/05 00:00:00.000;20;19;1;0.3002309469;0.0014727435
67110;2015/07/04 00:00:00.000;19;14;5;0.3516704346;0.0016436671
67117;2015/07/04 00:00:00.000;5;8;-3;0.0334924223;0.0001565397
67117;2015/09/05 00:00:00.000;3;2;1;0.0461893764;0.0002265759
67118;2015/09/05 00:00:00.000;4;2;2;0.0153964588;0.0000755253
67120;2015/07/04 00:00:00.000;2;3;-1;0.0251193168;0.0001174048
67120;2015/09/05 00:00:00.000;2;2;0;0.0153964588;0.0000755253
67133;2015/07/04 00:00:00.000;22;21;1;0.3600435401;0.001682802
67133;2015/09/05 00:00:00.000;16;18;-2;0.3926096998;0.0019258953
67135;2015/09/05 00:00:00.000;6;3;3;0.0538876059;0.0002643386
67144;2015/07/04 00:00:00.000;6;7;-1;0.0334924223;0.0001565397
67144;2015/09/05 00:00:00.000;3;4;-1;0.1308698999;0.0006419651
67146;2015/07/04 00:00:00.000;3;2;1;0.0167462112;0.0000782699
67149;2015/09/05 00:00:00.000;5;6;-1;0.0307929176;0.0001510506
67151;2015/07/04 00:00:00.000;1;1;0;0.0076787223;0.0000367031
67152;2015/09/05 00:00:00.000;15;9;6;0.415704388;0.0020391833
67202;2015/07/04 00:00:00.000;3;3;0;0.0502386335;0.0002348096
67203;2015/07/04 00:00:00.000;53;50;3;1.5155321109;0.0070834224
67205;2015/07/04 00:00:00.000;66;69;-3;1.0550113037;0.0049310012
67206;2015/07/04 00:00:00.000;53;53;0;1.3983086327;0.0065355333
67208;2015/07/04 00:00:00.000;45;44;1;0.988026459;0.0046179218
67209;2015/07/04 00:00:00.000;25;24;1;0.8289374529;0.0038743581
67212;2015/07/04 00:00:00.000;75;61;14;1.9927991292;0.0093141134
67213;2015/07/04 00:00:00.000;34;33;1;0.443774596;0.0020741513
67215;2015/07/04 00:00:00.000;16;16;0;0.4856401239;0.002269826
67216;2015/07/04 00:00:00.000;29;28;1;0.4102821737;0.0019176116
67218;2015/07/04 00:00:00.000;48;51;-3;0.9126685087;0.0042657074
67219;2015/07/04 00:00:00.000;30;31;-1;0.4940132295;0.0023089609
67223;2015/07/04 00:00:00.000;1;1;0;0.0167462112;0.0000782699
67226;2015/07/04 00:00:00.000;152;142;10;1.088503726;0.0050875409
67228;2015/07/04 00:00:00.000;12;11;1;0.1088503726;0.0005087541
67230;2015/07/04 00:00:00.000;67;60;7;1.0131457758;0.0047353266
67235;2015/07/04 00:00:00.000;51;50;1;1.2810851545;0.0059876443
67333;2015/07/04 00:00:00.000;11;10;1;0.0669848447;0.0003130794
67335;2015/07/04 00:00:00.000;8;8;0;0.0586117391;0.0002739445
67356;2015/07/04 00:00:00.000;3;3;0;0.0586117391;0.0002739445
67410;2015/07/04 00:00:00.000;70;73;-3;0.4688939128;0.0021915561
67428;2015/07/04 00:00:00.000;3;2;1;0.0543858286;0.0002722544
67432;2015/07/04 00:00:00.000;9;9;0;0.100477267;0.0004696192
67436;2015/07/04 00:00:00.000;1;1;0;0.0155388082;0.000077787
67439;2015/07/04 00:00:00.000;2;3;-1;0.0167462112;0.0000782699
67443;2015/07/04 00:00:00.000;3;3;0;0.0388470204;0.0001944674
67451;2015/07/04 00:00:00.000;16;24;-8;0.0083731056;0.0000391349
67456;2015/07/04 00:00:00.000;14;16;-2;0.5275056518;0.0024655006
67460;2015/07/04 00:00:00.000;55;56;-1;0.5526249686;0.0025829054
67464;2015/07/04 00:00:00.000;1;1;0;0.0251193168;0.0001174048
67467;2015/07/04 00:00:00.000;3;3;0;0.0083731056;0.0000391349
67468;2015/07/04 00:00:00.000;1;1;0;0.0076787223;0.0000367031
67470;2015/07/04 00:00:00.000;1;1;0;0.0077694041;0.0000388935
67501;2015/07/04 00:00:00.000;25;23;2;0.4019090681;0.0018784766
67502;2015/07/04 00:00:00.000;41;38;3;0.7703257138;0.0036004136
67516;2015/07/04 00:00:00.000;1;1;0;0.0077694041;0.0000388935
67523;2015/07/04 00:00:00.000;1;1;0;0.0077694041;0.0000388935
67529;2015/07/04 00:00:00.000;1;1;0;0.0167462112;0.0000782699
67530;2015/07/04 00:00:00.000;13;17;-4;0.4019090681;0.0018784766
67543;2015/07/04 00:00:00.000;2;2;0;0.0837310558;0.0003913493
67548;2015/07/04 00:00:00.000;1;1;0;0.0077694041;0.0000388935
67550;2015/07/04 00:00:00.000;1;3;-2;0.0083731056;0.0000391349
67560;2015/07/04 00:00:00.000;1;1;0;0.0083731056;0.0000391349
67570;2015/07/04 00:00:00.000;3;4;-1;0.0167462112;0.0000782699
67579;2015/07/04 00:00:00.000;5;4;1;0.100477267;0.0004696192
67647;2015/07/04 00:00:00.000;1;1;0;0.0155388082;0.000077787
77301;2015/07/04 00:00:00.000;52;54;-2;0.0615867529;0.0048527313
77302;2015/09/05 00:00:00.000;55;41;14;0.0634597684;0.0049469076
77302;2015/07/04 00:00:00.000;40;33;7;0.08095678;0.0063789936
77303;2015/09/05 00:00:00.000;45;37;8;0.0697573027;0.0054378221
77303;2015/07/04 00:00:00.000;31;29;2;0.0596000834;0.0046961916
77304;2015/09/05 00:00:00.000;190;164;26;0.1007605484;0.0078546319
77304;2015/07/04 00:00:00.000;103;98;5;0.1137368259;0.008961899
77316;2015/07/04 00:00:00.000;142;138;4;0.1057901481;0.0083357401
77316;2015/09/05 00:00:00.000;169;150;19;0.1094802112;0.0085343597
77327;2015/07/04 00:00:00.000;19;20;-1;0.0566200793;0.004461382
77327;2015/09/05 00:00:00.000;42;20;22;0.0353630771;0.0027566737
77328;2015/09/05 00:00:00.000;29;15;14;0.0348786514;0.002718911
77338;2015/07/04 00:00:00.000;66;59;7;0.1082734849;0.0085314148
77338;2015/09/05 00:00:00.000;85;71;14;0.118199874;0.0092140874
77345;2015/09/05 00:00:00.000;182;118;64;0.0799302427;0.0062308378
77346;2015/07/04 00:00:00.000;145;148;-3;0.2244936476;0.0176889884
77351;2015/09/05 00:00:00.000;171;83;88;0.128372814;0.0100071032
77354;2015/07/04 00:00:00.000;155;147;8;0.1624102274;0.0127971222
77355;2015/07/04 00:00:00.000;60;60;0;0.1201935016;0.0094706531
77356;2015/09/05 00:00:00.000;431;279;152;0.1947391368;0.0151805867
77357;2015/07/04 00:00:00.000;17;17;0;0.0451967299;0.0035612786
77357;2015/09/05 00:00:00.000;30;17;13;0.0290655428;0.0022657592
77358;2015/09/05 00:00:00.000;10;9;1;0.0305188199;0.0023790472
77358;2015/07/04 00:00:00.000;6;4;2;0.0253300355;0.0019958814
77363;2015/09/05 00:00:00.000;6;5;1;0.0169549;0.0013216929
77363;2015/07/04 00:00:00.000;3;3;0;0.010926682;0.0008609685
77364;2015/09/05 00:00:00.000;22;11;11;0.0164704743;0.0012839302
77364;2015/07/04 00:00:00.000;12;10;2;0.0248333681;0.0019567465
77365;2015/07/04 00:00:00.000;86;102;-16;0.0735067696;0.0057919697
77371;2015/09/05 00:00:00.000;14;11;3;0.00678196;0.0005286771
77371;2015/07/04 00:00:00.000;6;4;2;0.0243367007;0.0019176116
77372;2015/09/05 00:00:00.000;24;16;8;0.0334253742;0.0026056231
77375;2015/09/05 00:00:00.000;662;506;156;0.1913481568;0.0149162481
77375;2015/07/04 00:00:00.000;394;398;-4;0.1604235579;0.0126405825
77378;2015/07/04 00:00:00.000;42;43;-1;0.0759901064;0.0059876443
77379;2015/07/04 00:00:00.000;217;237;-20;0.2975037498;0.0234418232
77379;2015/09/05 00:00:00.000;321;238;83;0.3318316136;0.0258674176
77380;2015/09/05 00:00:00.000;408;250;158;0.1603449111;0.0124994383
77382;2015/07/04 00:00:00.000;518;522;-4;0.2398903358;0.0189021713
77384;2015/09/05 00:00:00.000;103;98;5;0.0610376399;0.0047580943
77385;2015/07/04 00:00:00.000;84;76;8;0.1038034787;0.0081792004
77385;2015/09/05 00:00:00.000;96;84;12;0.0847744998;0.0066084643
77386;2015/09/05 00:00:00.000;259;240;19;0.2107251853;0.0164267542
77386;2015/07/04 00:00:00.000;200;205;-5;0.2160503025;0.0170236946
77396;2015/09/05 00:00:00.000;113;71;42;0.1366080512;0.0106490683
77401;2015/07/04 00:00:00.000;48;51;-3;0.0546334098;0.0043048423
77406;2015/09/05 00:00:00.000;230;156;74;0.1739088311;0.0135567926
77407;2015/07/04 00:00:00.000;153;154;-1;0.1688669031;0.0133058763
77407;2015/09/05 00:00:00.000;178;126;52;0.204427651;0.0159358397
77414;2015/07/04 00:00:00.000;124;138;-14;0.0993334724;0.007826986
77417;2015/09/05 00:00:00.000;5;3;2;0.00339098;0.0002643386
77418;2015/09/05 00:00:00.000;43;13;30;0.062490917;0.0048713823
77422;2015/09/05 00:00:00.000;34;13;21;0.0290655428;0.0022657592
77422;2015/07/04 00:00:00.000;21;21;0;0.039733389;0.0031307944
77423;2015/09/05 00:00:00.000;48;28;20;0.0319720971;0.0024923351
77429;2015/07/04 00:00:00.000;214;213;1;0.3104171013;0.0244593314
77429;2015/09/05 00:00:00.000;337;273;64;0.3245652279;0.0253009778
77430;2015/07/04 00:00:00.000;1;1;0;0.0029800042;0.0002348096
77430;2015/09/05 00:00:00.000;4;2;2;0.0121106428;0.0009440663
77433;2015/09/05 00:00:00.000;448;397;51;0.2950152594;0.0229974559
77433;2015/07/04 00:00:00.000;358;335;23;0.2811137269;0.0221503705
77434;2015/07/04 00:00:00.000;8;10;-2;0.0024833368;0.0001956747
77437;2015/09/05 00:00:00.000;33;12;21;0.0232524342;0.0018126074
77437;2015/07/04 00:00:00.000;16;15;1;0.0382433869;0.0030133896
77441;2015/09/05 00:00:00.000;129;109;20;0.0644286199;0.0050224329
77444;2015/07/04 00:00:00.000;1;1;0;0.0014900021;0.0001174048
77445;2015/09/05 00:00:00.000;94;68;26;0.0232524342;0.0018126074
77449;2015/09/05 00:00:00.000;250;213;37;0.4863634162;0.037913704
77449;2015/07/04 00:00:00.000;161;144;17;0.3834272035;0.0302121661
77455;2015/07/04 00:00:00.000;1;2;-1;0.0019866694;0.0001565397
77455;2015/09/05 00:00:00.000;1;2;-1;0.0009688514;0.0000755253
77459;2015/09/05 00:00:00.000;250;189;61;0.2921087051;0.02277088
77459;2015/07/04 00:00:00.000;214;216;-2;0.2890604047;0.0227765294
77469;2015/07/04 00:00:00.000;326;330;-4;0.1639002295;0.012914527
77471;2015/07/04 00:00:00.000;58;58;0;0.063076755;0.0049701361
77474;2015/09/05 00:00:00.000;44;27;17;0.0460204428;0.0035874521
77477;2015/07/04 00:00:00.000;32;42;-10;0.0650634244;0.0051266759
77478;2015/09/05 00:00:00.000;53;38;15;0.0939785884;0.0073259548
77478;2015/07/04 00:00:00.000;41;35;6;0.1395635287;0.0109969154
77479;2015/09/05 00:00:00.000;290;203;87;0.4219347963;0.0328912711
77484;2015/09/05 00:00:00.000;14;8;6;0.0280966914;0.0021902339
77486;2015/07/04 00:00:00.000;6;7;-1;0.0064566757;0.0005087541
77488;2015/09/05 00:00:00.000;37;15;22;0.0532868285;0.0041538919
77493;2015/07/04 00:00:00.000;134;135;-1;0.1599268906;0.0126014475
77493;2015/09/05 00:00:00.000;145;147;-2;0.1782686625;0.0138966565
77494;2015/09/05 00:00:00.000;548;466;82;0.4103085792;0.0319849674
77498;2015/09/05 00:00:00.000;86;67;19;0.1569539311;0.0122350997
77503;2015/07/04 00:00:00.000;10;7;3;0.0352633827;0.00277858
77504;2015/09/05 00:00:00.000;25;11;14;0.0469892942;0.0036629774
77504;2015/07/04 00:00:00.000;12;14;-2;0.0620834203;0.0048918663
77505;2015/09/05 00:00:00.000;36;26;10;0.0649130456;0.0050601956
77510;2015/07/04 00:00:00.000;17;18;-1;0.0422167258;0.0033264691
77510;2015/09/05 00:00:00.000;36;31;5;0.0334253742;0.0026056231
77511;2015/09/05 00:00:00.000;87;60;27;0.1206220026;0.0094029007
77515;2015/07/04 00:00:00.000;50;48;2;0.091883462;0.0072399621
77515;2015/09/05 00:00:00.000;68;43;25;0.1550162283;0.0120840491
77520;2015/07/04 00:00:00.000;39;46;-7;0.0769834411;0.0060659142
77521;2015/09/05 00:00:00.000;134;118;16;0.1254662597;0.0097805272
77523;2015/07/04 00:00:00.000;436;496;-60;0.0844334515;0.0066529381
77530;2015/07/04 00:00:00.000;27;25;2;0.0531434077;0.0041874375
77532;2015/09/05 00:00:00.000;104;63;41;0.0668507484;0.0052112462
77534;2015/07/04 00:00:00.000;8;10;-2;0.0069533431;0.000547889
77534;2015/09/05 00:00:00.000;6;4;2;0.0092040886;0.0007174904
77535;2015/09/05 00:00:00.000;144;74;70;0.0779925398;0.0060797872
77539;2015/09/05 00:00:00.000;454;342;112;0.1375769026;0.0107245936
77539;2015/07/04 00:00:00.000;380;362;18;0.1499935433;0.0118187489
77545;2015/07/04 00:00:00.000;34;33;1;0.0635734223;0.0050092711
77546;2015/07/04 00:00:00.000;79;79;0;0.1658868989;0.0130710667
77546;2015/09/05 00:00:00.000;144;110;34;0.1879571768;0.0146519095
77547;2015/09/05 00:00:00.000;11;8;3;0.0145327714;0.0011328796
77550;2015/09/05 00:00:00.000;158;87;71;0.2228358281;0.0173708206
77550;2015/07/04 00:00:00.000;77;89;-12;0.3784605298;0.0298208168
77551;2015/09/05 00:00:00.000;129;68;61;0.1840817711;0.0143498083
77551;2015/07/04 00:00:00.000;66;73;-7;0.2413803379;0.0190195761
77554;2015/07/04 00:00:00.000;693;714;-21;0.3417071451;0.026924832
77554;2015/09/05 00:00:00.000;698;394;304;0.2858111709;0.0222799655
77562;2015/09/05 00:00:00.000;32;16;16;0.0329409485;0.0025678604
77562;2015/07/04 00:00:00.000;18;17;1;0.0144033535;0.001134913
77563;2015/07/04 00:00:00.000;96;90;6;0.0362567174;0.0028568499
77563;2015/09/05 00:00:00.000;168;100;68;0.0377852056;0.002945487
77564;2015/09/05 00:00:00.000;4;3;1;0.0014532771;0.000113288
77565;2015/07/04 00:00:00.000;46;52;-6;0.0302967091;0.0023872307
77565;2015/09/05 00:00:00.000;148;106;42;0.0402073342;0.0031343002
77566;2015/09/05 00:00:00.000;53;40;13;0.1128711912;0.0087986982
77566;2015/07/04 00:00:00.000;45;45;0;0.1584368885;0.0124840427
77568;2015/09/05 00:00:00.000;79;43;36;0.0503802742;0.003927316
77568;2015/07/04 00:00:00.000;47;50;-3;0.0551300772;0.0043439773
77571;2015/09/05 00:00:00.000;90;67;23;0.0702417284;0.0054755847
77571;2015/07/04 00:00:00.000;57;49;8;0.1117501565;0.0088053593
77573;2015/07/04 00:00:00.000;227;207;20;0.3571038333;0.0281380148
77575;2015/07/04 00:00:00.000;14;12;2;0.0273167049;0.0021524212
77575;2015/09/05 00:00:00.000;30;13;17;0.0217991571;0.0016993194
77577;2015/09/05 00:00:00.000;2;2;0;0.00339098;0.0002643386
77577;2015/07/04 00:00:00.000;2;2;0;0.0064566757;0.0005087541
77578;2015/09/05 00:00:00.000;48;30;18;0.0460204428;0.0035874521
77581;2015/09/05 00:00:00.000;222;144;78;0.2170227196;0.0169176687
77581;2015/07/04 00:00:00.000;109;100;9;0.1355901898;0.0106838359
77583;2015/09/05 00:00:00.000;80;63;17;0.0736327084;0.0057399233
77583;2015/07/04 00:00:00.000;40;40;0;0.0923801293;0.007279097
77584;2015/09/05 00:00:00.000;208;161;47;0.3323160393;0.0259051802
77584;2015/07/04 00:00:00.000;145;133;12;0.2329369928;0.0183542823
77586;2015/09/05 00:00:00.000;133;79;54;0.1109334883;0.0086476476
77587;2015/07/04 00:00:00.000;2;3;-1;0.0104300146;0.0008218335
77587;2015/09/05 00:00:00.000;8;3;5;0.0096885143;0.0007552531
77590;2015/09/05 00:00:00.000;79;44;35;0.0886499055;0.0069105656
77591;2015/07/04 00:00:00.000;18;13;5;0.0337733806;0.0026611753
77597;2015/07/04 00:00:00.000;1;1;0;0.0004966674;0.0000391349
77598;2015/07/04 00:00:00.000;15;14;1;0.0541367425;0.0042657074
77611;2015/09/05 00:00:00.000;19;16;3;0.0159860485;0.0012461676
77612;2015/07/04 00:00:00.000;11;12;-1;0.0293033744;0.0023089609
77612;2015/09/05 00:00:00.000;12;12;0;0.0222835828;0.0017370821
77616;2015/09/05 00:00:00.000;1;1;0;0.0004844257;0.0000377627
77617;2015/07/04 00:00:00.000;2;1;1;0.0024833368;0.0001956747
77617;2015/09/05 00:00:00.000;1;1;0;0.0014532771;0.000113288
77622;2015/09/05 00:00:00.000;1;1;0;0.0014532771;0.000113288
77622;2015/07/04 00:00:00.000;1;2;-1;0.0019866694;0.0001565397
77625;2015/09/05 00:00:00.000;11;7;4;0.0159860485;0.0012461676
77627;2015/07/04 00:00:00.000;35;32;3;0.0357600501;0.002817715
77630;2015/09/05 00:00:00.000;46;29;17;0.0280966914;0.0021902339
77630;2015/07/04 00:00:00.000;22;16;6;0.0228466987;0.0018002068
77632;2015/09/05 00:00:00.000;25;21;4;0.0300343942;0.0023412845
77640;2015/07/04 00:00:00.000;10;11;-1;0.0248333681;0.0019567465
77642;2015/07/04 00:00:00.000;26;26;0;0.041223391;0.0032481992
77642;2015/09/05 00:00:00.000;39;41;-2;0.0886499055;0.0069105656
77650;2015/07/04 00:00:00.000;236;212;24;0.1241668405;0.0097837325
77651;2015/09/05 00:00:00.000;20;15;5;0.0368163542;0.0028699617
77651;2015/07/04 00:00:00.000;16;17;-1;0.0367533848;0.0028959848
77656;2015/09/05 00:00:00.000;20;17;3;0.0314876714;0.0024545725
77657;2015/09/05 00:00:00.000;31;25;6;0.0329409485;0.0025678604
77657;2015/07/04 00:00:00.000;29;28;1;0.0600967508;0.0047353266
77659;2015/07/04 00:00:00.000;2;4;-2;0.0094366799;0.0007435637
77662;2015/07/04 00:00:00.000;26;21;5;0.0367533848;0.0028959848
77665;2015/09/05 00:00:00.000;11;8;3;0.0222835828;0.0017370821
77701;2015/07/04 00:00:00.000;4;6;-2;0.0124166841;0.0009783733
77701;2015/09/05 00:00:00.000;5;5;0;0.0184081771;0.0014349808
77702;2015/09/05 00:00:00.000;6;6;0;0.0140483457;0.0010951169
77703;2015/09/05 00:00:00.000;7;4;3;0.0096885143;0.0007552531
77705;2015/07/04 00:00:00.000;18;16;2;0.0377467195;0.0029742547
77705;2015/09/05 00:00:00.000;20;16;4;0.0377852056;0.002945487
77706;2015/09/05 00:00:00.000;105;89;16;0.1293416655;0.0100826285
77707;2015/07/04 00:00:00.000;30;30;0;0.0561234119;0.0044222471
77708;2015/09/05 00:00:00.000;19;16;3;0.0271278399;0.0021147086
77708;2015/07/04 00:00:00.000;10;7;3;0.0213566966;0.001682802
77802;2015/09/05 00:00:00.000;42;42;0;0.0915564598;0.0071371415
77803;2015/09/05 00:00:00.000;20;20;0;0.0804146684;0.0062686005
77803;2015/07/04 00:00:00.000;12;15;-3;0.041223391;0.0032481992
77807;2015/07/04 00:00:00.000;10;12;-2;0.0377467195;0.0029742547
77807;2015/09/05 00:00:00.000;14;9;5;0.0155016228;0.0012084049
77808;2015/09/05 00:00:00.000;18;17;1;0.0518335513;0.0040406039
77830;2015/09/05 00:00:00.000;5;5;0;0.0217991571;0.0016993194
77830;2015/07/04 00:00:00.000;1;1;0;0.0134100188;0.0010566431
77831;2015/07/04 00:00:00.000;3;3;0;0.0089400125;0.0007044287
77831;2015/09/05 00:00:00.000;6;2;4;0.0096885143;0.0007552531
77835;2015/09/05 00:00:00.000;1;1;0;0.0096885143;0.0007552531
77835;2015/07/04 00:00:00.000;2;2;0;0.0114233493;0.0009001034
77836;2015/07/04 00:00:00.000;5;5;0;0.0208600292;0.0016436671
77836;2015/09/05 00:00:00.000;7;4;3;0.0208303057;0.0016237941
77837;2015/09/05 00:00:00.000;3;2;1;0.0043598314;0.0003398639
77840;2015/09/05 00:00:00.000;27;29;-2;0.062490917;0.0048713823
77840;2015/07/04 00:00:00.000;18;25;-7;0.0690367633;0.0054397553
77845;2015/09/05 00:00:00.000;159;128;31;0.3168144165;0.0246967753
77845;2015/07/04 00:00:00.000;138;140;-2;0.3039604255;0.0239505773
77853;2015/09/05 00:00:00.000;2;2;0;0.0014532771;0.000113288
77856;2015/07/04 00:00:00.000;7;6;1;0.0084433452;0.0006652938
77859;2015/09/05 00:00:00.000;8;10;-2;0.0121106428;0.0009440663
77861;2015/09/05 00:00:00.000;4;2;2;0.0106573657;0.0008307784
77864;2015/09/05 00:00:00.000;8;4;4;0.01356392;0.0010573543
77864;2015/07/04 00:00:00.000;2;3;-1;0.0139066861;0.001095778
77868;2015/09/05 00:00:00.000;22;9;13;0.0765392627;0.0059664992
77871;2015/09/05 00:00:00.000;15;12;3;0.0208303057;0.0016237941
77872;2015/09/05 00:00:00.000;1;1;0;0.0024221286;0.0001888133
77904;2015/07/04 00:00:00.000;22;19;3;0.0958568009;0.0075530415
77950;2015/09/05 00:00:00.000;1;1;0;0.00678196;0.0005286771
77963;2015/07/04 00:00:00.000;3;3;0;0.0064566757;0.0005087541
77964;2015/09/05 00:00:00.000;7;4;3;0.0232524342;0.0018126074
77968;2015/07/04 00:00:00.000;2;3;-1;0.0084433452;0.0006652938
77971;2015/09/05 00:00:00.000;1;1;0;0.0024221286;0.0001888133
77975;2015/07/04 00:00:00.000;1;2;-1;0.0004966674;0.0000391349
77979;2015/07/04 00:00:00.000;21;17;4;0.0784734432;0.006183319
77979;2015/09/05 00:00:00.000;20;18;2;0.0595843627;0.0046448064
77983;2015/07/04 00:00:00.000;1;1;0;0.0114233493;0.0009001034
77994;2015/07/04 00:00:00.000;1;1;0;0.0004966674;0.0000391349
77995;2015/07/04 00:00:00.000;2;2;0;0.0104300146;0.0008218335
78002;2015/09/05 00:00:00.000;1;1;0;0.0096885143;0.0007552531
78002;2015/07/04 00:00:00.000;2;2;0;0.0089400125;0.0007044287
78004;2015/09/05 00:00:00.000;1;2;-1;0.0009688514;0.0000755253
78006;2015/07/04 00:00:00.000;125;148;-23;0.3178671117;0.0250463553
78009;2015/09/05 00:00:00.000;8;7;1;0.0406917599;0.0031720629
78010;2015/07/04 00:00:00.000;17;19;-2;0.0153966882;0.0012131828
78013;2015/09/05 00:00:00.000;10;8;2;0.0595843627;0.0046448064
78013;2015/07/04 00:00:00.000;8;12;-4;0.0337733806;0.0026611753
78014;2015/09/05 00:00:00.000;2;2;0;0.0014532771;0.000113288
78023;2015/07/04 00:00:00.000;107;109;-2;0.1182068322;0.0093141134
78024;2015/09/05 00:00:00.000;2;4;-2;0.0140483457;0.0010951169
78025;2015/09/05 00:00:00.000;11;7;4;0.0377852056;0.002945487
78025;2015/07/04 00:00:00.000;16;21;-5;0.0258267028;0.0020350164
78026;2015/07/04 00:00:00.000;2;1;1;0.0094366799;0.0007435637
78028;2015/09/05 00:00:00.000;119;110;9;0.5280240275;0.0411612922
78028;2015/07/04 00:00:00.000;129;152;-23;0.4117372431;0.0324428571
78041;2015/07/04 00:00:00.000;24;22;2;0.0948634661;0.0074747717
78043;2015/09/05 00:00:00.000;7;7;0;0.0300343942;0.0023412845
78045;2015/07/04 00:00:00.000;43;47;-4;0.1802902524;0.0142059797
78046;2015/09/05 00:00:00.000;48;54;-6;0.0610376399;0.0047580943
78055;2015/07/04 00:00:00.000;2;1;1;0.0074500104;0.000587024
78056;2015/07/04 00:00:00.000;3;3;0;0.0119200167;0.0009392383
78057;2015/07/04 00:00:00.000;1;1;0;0.0014900021;0.0001174048
78059;2015/09/05 00:00:00.000;3;4;-1;0.0164704743;0.0012839302
78059;2015/07/04 00:00:00.000;5;5;0;0.0149000209;0.0011740479
78063;2015/07/04 00:00:00.000;44;42;2;0.0839367842;0.0066138032
78064;2015/07/04 00:00:00.000;18;17;1;0.0581100814;0.0045787868
78069;2015/07/04 00:00:00.000;3;3;0;0.0094366799;0.0007435637
78070;2015/09/05 00:00:00.000;45;45;0;0.1152933198;0.0089875115
78073;2015/07/04 00:00:00.000;8;7;1;0.0203633618;0.0016045321
78101;2015/09/05 00:00:00.000;5;5;0;0.0310032457;0.0024168098
78102;2015/09/05 00:00:00.000;6;6;0;0.0116262171;0.0009063037
78102;2015/07/04 00:00:00.000;3;4;-1;0.0153966882;0.0012131828
78108;2015/09/05 00:00:00.000;343;344;-1;0.1569539311;0.0122350997
78108;2015/07/04 00:00:00.000;506;538;-32;0.1425435329;0.011231725
78109;2015/07/04 00:00:00.000;64;76;-12;0.0928767967;0.0073182319
78109;2015/09/05 00:00:00.000;94;102;-8;0.1235285569;0.0096294766
78112;2015/07/04 00:00:00.000;4;7;-3;0.0094366799;0.0007435637
78112;2015/09/05 00:00:00.000;5;8;-3;0.0111417914;0.000868541
78119;2015/09/05 00:00:00.000;1;1;0;0.0029065543;0.0002265759
78121;2015/09/05 00:00:00.000;25;20;5;0.0576466599;0.0044937558
78121;2015/07/04 00:00:00.000;27;29;-2;0.0620834203;0.0048918663
78124;2015/09/05 00:00:00.000;8;5;3;0.0300343942;0.0023412845
78130;2015/07/04 00:00:00.000;141;154;-13;0.3764738604;0.0296642771
78132;2015/09/05 00:00:00.000;114;151;-37;0.2664341423;0.0207694594
78132;2015/07/04 00:00:00.000;154;174;-20;0.2612470324;0.0205849733
78133;2015/07/04 00:00:00.000;65;60;5;0.3064437624;0.0241462519
78133;2015/09/05 00:00:00.000;73;73;0;0.287264448;0.0223932535
78140;2015/09/05 00:00:00.000;3;3;0;0.0043598314;0.0003398639
78147;2015/07/04 00:00:00.000;4;3;1;0.0034766715;0.0002739445
78151;2015/09/05 00:00:00.000;1;1;0;0.0009688514;0.0000755253
78152;2015/09/05 00:00:00.000;2;2;0;0.0125950685;0.000981829
78152;2015/07/04 00:00:00.000;2;3;-1;0.0188733598;0.0014871273
78155;2015/07/04 00:00:00.000;27;30;-3;0.1003268071;0.0079052559
78160;2015/07/04 00:00:00.000;1;1;0;0.0144033535;0.001134913
78163;2015/07/04 00:00:00.000;26;28;-2;0.0486734015;0.0038352232
78163;2015/09/05 00:00:00.000;21;14;7;0.079445817;0.0061930752
78202;2015/07/04 00:00:00.000;5;7;-2;0.0283100396;0.002230691
78203;2015/07/04 00:00:00.000;2;2;0;0.0208600292;0.0016436671
78203;2015/09/05 00:00:00.000;2;1;1;0.0053286828;0.0004153892
78204;2015/09/05 00:00:00.000;2;3;-1;0.0198614542;0.0015482688
78205;2015/07/04 00:00:00.000;1;1;0;0.0163900229;0.0012914527
78207;2015/09/05 00:00:00.000;10;8;2;0.0324565228;0.0025300978
78207;2015/07/04 00:00:00.000;5;6;-1;0.0437067279;0.0034438739
78208;2015/07/04 00:00:00.000;1;1;0;0.0153966882;0.0012131828
78208;2015/09/05 00:00:00.000;1;1;0;0.0048442571;0.0003776265
78210;2015/07/04 00:00:00.000;13;15;-2;0.1236701731;0.0097445976
78211;2015/07/04 00:00:00.000;8;8;0;0.017880025;0.0014088575
78211;2015/09/05 00:00:00.000;7;9;-2;0.0353630771;0.0027566737
78212;2015/09/05 00:00:00.000;92;86;6;0.1772998111;0.0138211312
78213;2015/07/04 00:00:00.000;33;30;3;0.1375768593;0.0108403757
78214;2015/07/04 00:00:00.000;6;7;-1;0.0203633618;0.0016045321
78215;2015/09/05 00:00:00.000;2;2;0;0.0024221286;0.0001888133
78216;2015/09/05 00:00:00.000;39;33;6;0.0954318655;0.0074392427
78216;2015/07/04 00:00:00.000;36;32;4;0.1341001877;0.0105664312
78217;2015/07/04 00:00:00.000;16;13;3;0.1082734849;0.0085314148
78218;2015/07/04 00:00:00.000;22;23;-1;0.0551300772;0.0043439773
78219;2015/07/04 00:00:00.000;8;8;0;0.0124166841;0.0009783733
78219;2015/09/05 00:00:00.000;4;5;-1;0.0198614542;0.0015482688
78220;2015/09/05 00:00:00.000;5;2;3;0.0300343942;0.0023412845
78222;2015/07/04 00:00:00.000;33;34;-1;0.0695334307;0.0054788902
78223;2015/07/04 00:00:00.000;84;86;-2;0.109763487;0.0086488196
78223;2015/09/05 00:00:00.000;69;86;-17;0.0925253112;0.0072126668
78224;2015/09/05 00:00:00.000;17;25;-8;0.0469892942;0.0036629774
78225;2015/07/04 00:00:00.000;5;3;2;0.0268200375;0.0021132862
78227;2015/09/05 00:00:00.000;13;12;1;0.0716950056;0.0055888727
78228;2015/09/05 00:00:00.000;25;19;6;0.0838056484;0.006532939
78229;2015/07/04 00:00:00.000;24;22;2;0.0839367842;0.0066138032
78230;2015/07/04 00:00:00.000;118;110;8;0.2145603004;0.0169062898
78231;2015/09/05 00:00:00.000;64;68;-4;0.0455360171;0.0035496894
78231;2015/07/04 00:00:00.000;26;24;2;0.0456933973;0.0036004136
78232;2015/09/05 00:00:00.000;97;101;-4;0.1797219396;0.0140099444
78232;2015/07/04 00:00:00.000;114;108;6;0.1589335558;0.0125231777
78238;2015/07/04 00:00:00.000;54;42;12;0.046686732;0.0036786834
78238;2015/09/05 00:00:00.000;90;72;18;0.0847744998;0.0066084643
78239;2015/09/05 00:00:00.000;210;196;14;0.131763794;0.0102714417
78239;2015/07/04 00:00:00.000;140;92;48;0.1201935016;0.0094706531
78242;2015/07/04 00:00:00.000;7;4;3;0.0263233702;0.0020741513
78242;2015/09/05 00:00:00.000;14;16;-2;0.0295499685;0.0023035219
78245;2015/07/04 00:00:00.000;203;224;-21;0.3675338479;0.0289598483
78247;2015/09/05 00:00:00.000;80;68;12;0.2397907281;0.0186925134
78250;2015/07/04 00:00:00.000;42;43;-1;0.2518103525;0.0198414096
78250;2015/09/05 00:00:00.000;69;59;10;0.1923170082;0.0149917734
78251;2015/07/04 00:00:00.000;54;57;-3;0.1708535725;0.013462416
78251;2015/09/05 00:00:00.000;66;49;17;0.1206220026;0.0094029007
78253;2015/07/04 00:00:00.000;344;365;-21;0.3824338687;0.0301338963
78254;2015/07/04 00:00:00.000;204;262;-58;0.2443603421;0.0192543857
78254;2015/09/05 00:00:00.000;162;181;-19;0.1758465339;0.0137078432
78255;2015/09/05 00:00:00.000;64;63;1;0.1608293368;0.0125372009
78256;2015/07/04 00:00:00.000;32;35;-3;0.0556267445;0.0043831122
78257;2015/07/04 00:00:00.000;48;46;2;0.0998301398;0.007866121
78259;2015/09/05 00:00:00.000;68;66;2;0.1017293998;0.0079301572
78260;2015/09/05 00:00:00.000;149;189;-40;0.2829046166;0.0220533896
78260;2015/07/04 00:00:00.000;185;176;9;0.2577703609;0.0203110288
78261;2015/07/04 00:00:00.000;143;168;-25;0.1663835663;0.0131102016
78263;2015/09/05 00:00:00.000;8;4;4;0.0222835828;0.0017370821
78264;2015/07/04 00:00:00.000;7;6;1;0.0456933973;0.0036004136
78264;2015/09/05 00:00:00.000;7;5;2;0.0305188199;0.0023790472
78332;2015/07/04 00:00:00.000;13;11;2;0.0278133723;0.0021915561
78332;2015/09/05 00:00:00.000;10;11;-1;0.0339097999;0.0026433857
78336;2015/09/05 00:00:00.000;42;48;-6;0.0605532142;0.0047203317
78336;2015/07/04 00:00:00.000;120;114;6;0.0675467612;0.0053223505
78343;2015/07/04 00:00:00.000;4;4;0;0.0069533431;0.000547889
78355;2015/07/04 00:00:00.000;1;1;0;0.0064566757;0.0005087541
78358;2015/09/05 00:00:00.000;2;2;0;0.0188926028;0.0014727435
78359;2015/09/05 00:00:00.000;2;1;1;0.0038754057;0.0003021012
78359;2015/07/04 00:00:00.000;1;1;0;0.0059600083;0.0004696192
78362;2015/09/05 00:00:00.000;35;26;9;0.0358475028;0.0027944364
78363;2015/09/05 00:00:00.000;21;24;-3;0.0334253742;0.0026056231
78363;2015/07/04 00:00:00.000;20;20;0;0.0596000834;0.0046961916
78370;2015/07/04 00:00:00.000;11;8;3;0.0104300146;0.0008218335
78370;2015/09/05 00:00:00.000;4;2;2;0.00678196;0.0005286771
78372;2015/09/05 00:00:00.000;5;3;2;0.0048442571;0.0003776265
78373;2015/07/04 00:00:00.000;63;71;-8;0.2314469907;0.0182368775
78373;2015/09/05 00:00:00.000;71;64;7;0.2267112338;0.0176729218
78374;2015/07/04 00:00:00.000;39;37;2;0.0501634036;0.0039526279
78377;2015/07/04 00:00:00.000;1;1;0;0.0049666736;0.0003913493
78377;2015/09/05 00:00:00.000;4;5;-1;0.0058131086;0.0004531518
78380;2015/09/05 00:00:00.000;15;18;-3;0.0440827399;0.0034364015
78382;2015/07/04 00:00:00.000;153;149;4;0.3645538437;0.0287250388
78383;2015/09/05 00:00:00.000;8;7;1;0.0261589885;0.0020391833
78387;2015/09/05 00:00:00.000;7;9;-2;0.0140483457;0.0010951169
78387;2015/07/04 00:00:00.000;2;3;-1;0.0144033535;0.001134913
78390;2015/07/04 00:00:00.000;6;5;1;0.0089400125;0.0007044287
78393;2015/09/05 00:00:00.000;1;2;-1;0.0009688514;0.0000755253
78401;2015/09/05 00:00:00.000;5;3;2;0.0169549;0.0013216929
78402;2015/07/04 00:00:00.000;5;7;-2;0.0144033535;0.001134913
78404;2015/09/05 00:00:00.000;28;29;-1;0.0939785884;0.0073259548
78405;2015/09/05 00:00:00.000;6;6;0;0.0096885143;0.0007552531
78407;2015/07/04 00:00:00.000;1;1;0;0.0049666736;0.0003913493
78408;2015/09/05 00:00:00.000;10;8;2;0.02034588;0.0015860314
78410;2015/07/04 00:00:00.000;51;49;2;0.2120769636;0.0167106152
78411;2015/07/04 00:00:00.000;38;33;5;0.1072801502;0.0084531449
78411;2015/09/05 00:00:00.000;40;35;5;0.1244974083;0.0097050019
78412;2015/09/05 00:00:00.000;51;48;3;0.1690645739;0.013179166
78413;2015/07/04 00:00:00.000;68;69;-1;0.2806170595;0.0221112356
78414;2015/09/05 00:00:00.000;97;102;-5;0.415637262;0.0324003566
78414;2015/07/04 00:00:00.000;95;94;1;0.4037905653;0.0318166982
78415;2015/09/05 00:00:00.000;23;23;0;0.079445817;0.0061930752
78416;2015/07/04 00:00:00.000;10;10;0;0.023343366;0.0018393417
78417;2015/07/04 00:00:00.000;3;2;1;0.0104300146;0.0008218335
78501;2015/09/05 00:00:00.000;31;29;2;0.1099646369;0.0085721223
78501;2015/07/04 00:00:00.000;30;24;6;0.1052934807;0.0082966052
78504;2015/07/04 00:00:00.000;62;66;-4;0.1956869406;0.0154191625
78504;2015/09/05 00:00:00.000;79;73;6;0.1937702853;0.0151050614
78521;2015/07/04 00:00:00.000;43;48;-5;0.0968501356;0.0076313114
78539;2015/09/05 00:00:00.000;28;20;8;0.052317977;0.0040783666
78543;2015/09/05 00:00:00.000;1;1;0;0.0029065543;0.0002265759
78550;2015/09/05 00:00:00.000;52;48;4;0.1104490626;0.008609885
88026;2015/09/05 00:00:00.000;6;6;0;0.0118715498;0.0000755253
88027;2015/09/05 00:00:00.000;1;1;0;0.0237430997;0.0001510506
88041;2015/09/05 00:00:00.000;10;12;-2;0.0059357749;0.0000377627
88044;2015/09/05 00:00:00.000;3;3;0;0.0652935241;0.0004153892
88045;2015/09/05 00:00:00.000;5;6;-1;0.0178073247;0.000113288
88048;2015/09/05 00:00:00.000;4;4;0;0.0237430997;0.0001510506
88049;2015/09/05 00:00:00.000;4;3;1;0.1721374725;0.0010951169
88061;2015/09/05 00:00:00.000;92;84;8;0.6648067905;0.0042294172
88065;2015/09/05 00:00:00.000;2;2;0;0.0059357749;0.0000377627
88072;2015/09/05 00:00:00.000;3;4;-1;0.0593577492;0.0003776265
88124;2015/09/05 00:00:00.000;1;1;0;0.0059357749;0.0000377627
88201;2015/09/05 00:00:00.000;45;45;0;1.0090817356;0.0064196511
88256;2015/09/05 00:00:00.000;1;1;0;0.0059357749;0.0000377627
88260;2015/09/05 00:00:00.000;2;1;1;0.0949723986;0.0006042025
88312;2015/09/05 00:00:00.000;55;57;-2;0.7597791892;0.0048336196
88337;2015/09/05 00:00:00.000;7;10;-3;0.1127797234;0.0007174904
88341;2015/09/05 00:00:00.000;4;3;1;0.0474861993;0.0003021012
88346;2015/09/05 00:00:00.000;5;4;1;0.0771650739;0.0004909145
88351;2015/09/05 00:00:00.000;1;1;0;0.0237430997;0.0001510506
88401;2015/09/05 00:00:00.000;8;7;1;0.2374309966;0.0015105061
89005;2015/09/05 00:00:00.000;43;34;9;0.4332617855;0.0041161292
89007;2015/09/05 00:00:00.000;3;3;0;0.0278241514;0.0002643386
89015;2015/09/05 00:00:00.000;91;88;3;0.8824230861;0.0083833091
89020;2015/09/05 00:00:00.000;2;1;1;0.0914222116;0.000868541
89030;2015/09/05 00:00:00.000;47;42;5;0.238492726;0.0022657592
89031;2015/09/05 00:00:00.000;179;169;10;1.462755386;0.0138966565
89043;2015/09/05 00:00:00.000;2;3;-1;0.0198743938;0.0001888133
89044;2015/09/05 00:00:00.000;115;124;-9;1.1646394785;0.0110644575
89048;2015/09/05 00:00:00.000;75;71;4;1.053342873;0.0100071032
89060;2015/09/05 00:00:00.000;30;26;4;0.7115032991;0.006759515
89061;2015/09/05 00:00:00.000;31;32;-1;0.2782415136;0.0026433857
89081;2015/09/05 00:00:00.000;102;102;0;0.544558391;0.0051734835
89106;2015/09/05 00:00:00.000;40;35;5;0.4769854519;0.0045315184
89109;2015/09/05 00:00:00.000;67;74;-7;0.9142221162;0.0086854103
89110;2015/09/05 00:00:00.000;112;107;5;1.1646394785;0.0110644575
89117;2015/09/05 00:00:00.000;172;178;-6;2.7068924398;0.025716367
89118;2015/09/05 00:00:00.000;44;39;5;0.850624056;0.0080812078
89121;2015/09/05 00:00:00.000;120;118;2;1.3832578106;0.0131414034
89122;2015/09/05 00:00:00.000;141;143;-2;1.8920422927;0.017975023
89130;2015/09/05 00:00:00.000;77;68;9;1.3872326894;0.013179166
89131;2015/09/05 00:00:00.000;135;143;-8;2.7744653788;0.0263583321
89135;2015/09/05 00:00:00.000;127;139;-12;2.6949678035;0.025603079
89141;2015/09/05 00:00:00.000;125;134;-9;1.6297002941;0.0154826879
89144;2015/09/05 00:00:00.000;66;77;-11;1.4667302647;0.0139344191
89145;2015/09/05 00:00:00.000;82;89;-7;1.1884887511;0.0112910334
89149;2015/09/05 00:00:00.000;126;125;1;2.1225852611;0.0201652569
89158;2015/09/05 00:00:00.000;35;30;5;0.3935129979;0.0037385027
89183;2015/09/05 00:00:00.000;74;75;-1;1.0771921456;0.0102336791
89408;2015/09/05 00:00:00.000;60;67;-7;0.4094125129;0.0038895533
89418;2015/09/05 00:00:00.000;1;1;0;0.0079497575;0.0000755253
89423;2015/09/05 00:00:00.000;28;28;0;0.6161062088;0.0058532113
89433;2015/09/05 00:00:00.000;19;16;3;0.1947690595;0.00185037
89439;2015/09/05 00:00:00.000;2;3;-1;0.1589951506;0.0015105061
89444;2015/09/05 00:00:00.000;14;16;-2;0.1550202719;0.0014727435
89448;2015/09/05 00:00:00.000;21;21;0;0.544558391;0.0051734835
89449;2015/09/05 00:00:00.000;24;24;0;0.544558391;0.0051734835
89460;2015/09/05 00:00:00.000;38;38;0;0.6041815725;0.0057399233
89503;2015/09/05 00:00:00.000;41;47;-6;0.6479052389;0.0061553125
89508;2015/09/05 00:00:00.000;31;36;-5;0.6757293903;0.0064196511
89509;2015/09/05 00:00:00.000;70;69;1;0.3497893314;0.0033231135
89512;2015/09/05 00:00:00.000;28;23;5;0.3458144527;0.0032853508
89523;2015/09/05 00:00:00.000;73;65;8;1.5621273551;0.0148407228
89701;2015/09/05 00:00:00.000;37;28;9;0.7671516019;0.0072881921
89706;2015/09/05 00:00:00.000;64;64;0;0.5008347245;0.0047580943
89815;2015/09/05 00:00:00.000;48;50;-2;0.1788695445;0.0016993194
89835;2015/09/05 00:00:00.000;3;3;0;0.0158995151;0.0001510506
90003;2015/09/05 00:00:00.000;20;19;1;0.0442005481;0.0049091449
90004;2015/09/05 00:00:00.000;33;28;5;0.1846222893;0.0205051208
90008;2015/09/05 00:00:00.000;32;34;-2;0.0782009697;0.0086854103
90012;2015/09/05 00:00:00.000;15;15;0;0.0734409107;0.0081567331
90013;2015/09/05 00:00:00.000;7;6;1;0.0680008432;0.0075525307
90018;2015/09/05 00:00:00.000;13;15;-2;0.075480936;0.0083833091
90019;2015/09/05 00:00:00.000;38;40;-2;0.1910823694;0.0212226112
90022;2015/09/05 00:00:00.000;9;9;0;0.0374004638;0.0041538919
90023;2015/09/05 00:00:00.000;5;2;3;0.0224402783;0.0024923351
90026;2015/09/05 00:00:00.000;27;29;-2;0.2692833391;0.0299080215
90027;2015/09/05 00:00:00.000;38;35;3;0.2441230271;0.0271135852
90031;2015/09/05 00:00:00.000;11;12;-1;0.0680008432;0.0075525307
90032;2015/09/05 00:00:00.000;17;19;-2;0.0931611552;0.010346967
90036;2015/09/05 00:00:00.000;19;23;-4;0.1332816527;0.0148029601
90037;2015/09/05 00:00:00.000;10;10;0;0.0391004848;0.0043427051
90041;2015/09/05 00:00:00.000;26;26;0;0.0955411847;0.0106113056
90042;2015/09/05 00:00:00.000;50;48;2;0.2080825802;0.0231107439
90045;2015/09/05 00:00:00.000;52;45;7;0.0873810835;0.0097050019
90046;2015/09/05 00:00:00.000;208;212;-4;0.6545081159;0.0726931078
90056;2015/09/05 00:00:00.000;10;14;-4;0.0462405734;0.0051357209
90057;2015/09/05 00:00:00.000;5;7;-2;0.0217602698;0.0024168098
90061;2015/09/05 00:00:00.000;10;10;0;0.0343404258;0.003814028
90066;2015/09/05 00:00:00.000;33;37;-4;0.170002108;0.0188813267
90067;2015/09/05 00:00:00.000;20;19;1;0.0693608601;0.0077035813
90094;2015/09/05 00:00:00.000;8;9;-1;0.0431805354;0.004795857
90201;2015/09/05 00:00:00.000;12;18;-6;0.0241402993;0.0026811484
90211;2015/09/05 00:00:00.000;15;14;1;0.0632407842;0.0070238535
90212;2015/09/05 00:00:00.000;9;11;-2;0.0853410582;0.009478426
90221;2015/09/05 00:00:00.000;18;16;2;0.0438605439;0.0048713823
90222;2015/09/05 00:00:00.000;22;19;3;0.0282203499;0.0031343002
90230;2015/09/05 00:00:00.000;148;146;2;0.1292016021;0.0143498083
90240;2015/09/05 00:00:00.000;21;27;-6;0.0241402993;0.0026811484
90241;2015/09/05 00:00:00.000;18;20;-2;0.0391004848;0.0043427051
90249;2015/09/05 00:00:00.000;18;21;-3;0.0391004848;0.0043427051
90250;2015/09/05 00:00:00.000;27;34;-7;0.1152614292;0.0128015395
90260;2015/09/05 00:00:00.000;12;7;5;0.0275403415;0.0030587749
90265;2015/09/05 00:00:00.000;112;116;-4;1.189674752;0.1321315243
90266;2015/09/05 00:00:00.000;44;43;1;0.1985624622;0.0220533896
90274;2015/09/05 00:00:00.000;354;348;6;0.1577619562;0.0175218712
90275;2015/09/05 00:00:00.000;79;86;-7;0.1679620827;0.0186547508
90280;2015/09/05 00:00:00.000;19;18;1;0.0350204343;0.0038895533
90290;2015/09/05 00:00:00.000;19;19;0;0.1098213618;0.0121973371
90304;2015/09/05 00:00:00.000;3;2;1;0.0142801771;0.0015860314
90305;2015/09/05 00:00:00.000;10;10;0;0.0414805144;0.0046070437
90402;2015/09/05 00:00:00.000;22;23;-1;0.155721931;0.0172952953
90403;2015/09/05 00:00:00.000;19;21;-2;0.1264815684;0.0140477071
90501;2015/09/05 00:00:00.000;29;32;-3;0.0720808938;0.0080056825
90502;2015/09/05 00:00:00.000;13;17;-4;0.0435205397;0.0048336196
90505;2015/09/05 00:00:00.000;47;43;4;0.1244415431;0.0138211312
90604;2015/09/05 00:00:00.000;35;33;2;0.0411405101;0.0045692811
90605;2015/09/05 00:00:00.000;39;35;4;0.0380804722;0.0042294172
90621;2015/09/05 00:00:00.000;30;31;-1;0.0207402572;0.0023035219
90631;2015/09/05 00:00:00.000;232;246;-14;0.1414417539;0.0157092638
90640;2015/09/05 00:00:00.000;25;25;0;0.0384204764;0.0042671798
90660;2015/09/05 00:00:00.000;33;35;-2;0.0350204343;0.0038895533
90680;2015/09/05 00:00:00.000;20;20;0;0.0183602277;0.0020391833
90704;2015/09/05 00:00:00.000;9;11;-2;0.0231202867;0.0025678604
90706;2015/09/05 00:00:00.000;24;27;-3;0.0578007167;0.0064196511
90710;2015/09/05 00:00:00.000;26;33;-7;0.0238002951;0.0026433857
90715;2015/09/05 00:00:00.000;9;11;-2;0.0316203921;0.0035119268
90716;2015/09/05 00:00:00.000;6;3;3;0.0081601012;0.0009063037
90723;2015/09/05 00:00:00.000;21;29;-8;0.0357004427;0.0039650786
90740;2015/09/05 00:00:00.000;22;21;1;0.0686808516;0.007628056
90742;2015/09/05 00:00:00.000;6;5;1;0.0129201602;0.0014349808
90745;2015/09/05 00:00:00.000;23;20;3;0.0809210034;0.0089875115
90746;2015/09/05 00:00:00.000;16;14;2;0.0516806408;0.0057399233
90755;2015/09/05 00:00:00.000;24;26;-2;0.0166602066;0.00185037
90804;2015/09/05 00:00:00.000;23;29;-6;0.0656208137;0.0072881921
90805;2015/09/05 00:00:00.000;45;42;3;0.1244415431;0.0138211312
90810;2015/09/05 00:00:00.000;70;60;10;0.0547406788;0.0060797872
91001;2015/09/05 00:00:00.000;41;43;-2;0.1074413323;0.0119329985
91008;2015/09/05 00:00:00.000;4;4;0;0.0129201602;0.0014349808
91016;2015/09/05 00:00:00.000;50;53;-3;0.0697008643;0.007741344
91024;2015/09/05 00:00:00.000;13;10;3;0.0370604595;0.0041161292
91030;2015/09/05 00:00:00.000;24;21;3;0.0758209402;0.0084210717
91104;2015/09/05 00:00:00.000;23;32;-9;0.0877210877;0.0097427646
91105;2015/09/05 00:00:00.000;45;41;4;0.1030212775;0.011442084
91106;2015/09/05 00:00:00.000;48;47;1;0.0989412269;0.0109889321
91107;2015/09/05 00:00:00.000;41;45;-4;0.0948611763;0.0105357803
91201;2015/09/05 00:00:00.000;12;15;-3;0.03468043;0.0038517906
91202;2015/09/05 00:00:00.000;28;30;-2;0.0748009275;0.0083077838
91203;2015/09/05 00:00:00.000;11;10;1;0.0142801771;0.0015860314
91204;2015/09/05 00:00:00.000;5;5;0;0.0183602277;0.0020391833
91207;2015/09/05 00:00:00.000;13;12;1;0.022100274;0.0024545725
91208;2015/09/05 00:00:00.000;10;11;-1;0.0496406155;0.0055133474
91301;2015/09/05 00:00:00.000;196;224;-28;0.1077813365;0.0119707611
91304;2015/09/05 00:00:00.000;200;184;16;0.0703808727;0.0078168693
91307;2015/09/05 00:00:00.000;68;91;-23;0.0656208137;0.0072881921
91321;2015/09/05 00:00:00.000;242;234;8;0.0659608179;0.0073259548
91326;2015/09/05 00:00:00.000;258;264;-6;0.0768409528;0.0085343597
91331;2015/09/05 00:00:00.000;170;146;24;0.047260586;0.0052490088
91342;2015/09/05 00:00:00.000;57;66;-9;0.0877210877;0.0097427646
91345;2015/09/05 00:00:00.000;15;15;0;0.0197202445;0.0021902339
91351;2015/09/05 00:00:00.000;158;156;2;0.0306003794;0.0033986388
91352;2015/09/05 00:00:00.000;30;29;1;0.0289003584;0.0032098255
91362;2015/09/05 00:00:00.000;458;450;8;0.1584419647;0.0175973965
91377;2015/09/05 00:00:00.000;23;22;1;0.0316203921;0.0035119268
91390;2015/09/05 00:00:00.000;336;372;-36;0.1084613449;0.0120462864
91401;2015/09/05 00:00:00.000;188;172;16;0.1050613028;0.0116686599
91402;2015/09/05 00:00:00.000;27;32;-5;0.0306003794;0.0033986388
91403;2015/09/05 00:00:00.000;52;58;-6;0.1309016232;0.0145386216
91501;2015/09/05 00:00:00.000;23;21;2;0.0489606071;0.0054378221
91504;2015/09/05 00:00:00.000;28;23;5;0.0591607336;0.0065707017
91505;2015/09/05 00:00:00.000;31;29;2;0.0826210245;0.0091763248
91601;2015/09/05 00:00:00.000;19;18;1;0.0574607125;0.0063818884
91604;2015/09/05 00:00:00.000;93;93;0;0.3182439462;0.0353458436
91701;2015/09/05 00:00:00.000;218;242;-24;0.075480936;0.0083833091
91702;2015/09/05 00:00:00.000;50;57;-7;0.0578007167;0.0064196511
91708;2015/09/05 00:00:00.000;26;28;-2;0.0282203499;0.0031343002
91709;2015/09/05 00:00:00.000;179;200;-21;0.1451818003;0.016124653
91722;2015/09/05 00:00:00.000;24;22;2;0.0292403626;0.0032475882
91730;2015/09/05 00:00:00.000;83;90;-7;0.1196814841;0.013292454
91733;2015/09/05 00:00:00.000;34;36;-2;0.0108801349;0.0012084049
91741;2015/09/05 00:00:00.000;51;54;-3;0.0557606914;0.0061930752
91746;2015/09/05 00:00:00.000;19;21;-2;0.0129201602;0.0014349808
91752;2015/09/05 00:00:00.000;37;43;-6;0.0353604385;0.003927316
91754;2015/09/05 00:00:00.000;26;36;-10;0.032980409;0.0036629774
91759;2015/09/05 00:00:00.000;1;1;0;0.0085001054;0.0009440663
91762;2015/09/05 00:00:00.000;59;59;0;0.0476005902;0.0052867715
91763;2015/09/05 00:00:00.000;23;20;3;0.0268603331;0.0029832496
91766;2015/09/05 00:00:00.000;54;75;-21;0.0839810414;0.0093273754
91767;2015/09/05 00:00:00.000;45;53;-8;0.0445405523;0.0049469076
91770;2015/09/05 00:00:00.000;28;26;2;0.0367204553;0.0040783666
91776;2015/09/05 00:00:00.000;28;27;1;0.0210802614;0.0023412845
91786;2015/09/05 00:00:00.000;69;72;-3;0.0605207505;0.0067217523
91790;2015/09/05 00:00:00.000;37;34;3;0.0391004848;0.0043427051
91791;2015/09/05 00:00:00.000;39;48;-9;0.0469205818;0.0052112462
91803;2015/09/05 00:00:00.000;14;13;1;0.0258403204;0.0028699617
91901;2015/09/05 00:00:00.000;26;22;4;0.0510006324;0.005664398
91913;2015/09/05 00:00:00.000;53;50;3;0.1846222893;0.0205051208
91915;2015/09/05 00:00:00.000;46;36;10;0.1003012437;0.0111399828
91916;2015/09/05 00:00:00.000;1;1;0;0.0013600169;0.0001510506
91932;2015/09/05 00:00:00.000;18;21;-3;0.0584807252;0.0064951764
91935;2015/09/05 00:00:00.000;15;15;0;0.0200602487;0.0022279966
91941;2015/09/05 00:00:00.000;59;57;2;0.0948611763;0.0105357803
91942;2015/09/05 00:00:00.000;37;33;4;0.0741209191;0.0082322584
91963;2015/09/05 00:00:00.000;1;1;0;0.0061200759;0.0006797278
92008;2015/09/05 00:00:00.000;43;43;0;0.1162814419;0.0129148275
92010;2015/09/05 00:00:00.000;33;26;7;0.0567807041;0.0063063631
92011;2015/09/05 00:00:00.000;73;63;10;0.1598019815;0.0177484471
92014;2015/09/05 00:00:00.000;46;41;5;0.1057413112;0.0117441852
92019;2015/09/05 00:00:00.000;63;66;-3;0.0683408474;0.0075902933
92020;2015/09/05 00:00:00.000;56;50;6;0.0860210667;0.0095539513
92021;2015/09/05 00:00:00.000;84;79;5;0.1037012859;0.0115176093
92024;2015/09/05 00:00:00.000;82;86;-4;0.2046825381;0.0227331174
92025;2015/09/05 00:00:00.000;41;38;3;0.0574607125;0.0063818884
92026;2015/09/05 00:00:00.000;71;55;16;0.0962211931;0.0106868309
92027;2015/09/05 00:00:00.000;49;55;-6;0.1003012437;0.0111399828
92028;2015/09/05 00:00:00.000;151;157;-6;0.1910823694;0.0212226112
92029;2015/09/05 00:00:00.000;32;28;4;0.0761609444;0.0084588344
92036;2015/09/05 00:00:00.000;14;15;-1;0.0353604385;0.003927316
92037;2015/09/05 00:00:00.000;143;139;4;0.4868860374;0.0540761197
92040;2015/09/05 00:00:00.000;56;46;10;0.1285215937;0.014274283
92054;2015/09/05 00:00:00.000;60;57;3;0.1625220153;0.0180505483
92056;2015/09/05 00:00:00.000;69;58;11;0.1207014967;0.013405742
92057;2015/09/05 00:00:00.000;97;85;12;0.1785022134;0.019825393
92058;2015/09/05 00:00:00.000;25;21;4;0.0632407842;0.0070238535
92059;2015/09/05 00:00:00.000;1;1;0;0.0013600169;0.0001510506
92061;2015/09/05 00:00:00.000;7;6;1;0.0081601012;0.0009063037
92064;2015/09/05 00:00:00.000;87;82;5;0.1258015599;0.0139721818
92065;2015/09/05 00:00:00.000;83;76;7;0.0955411847;0.0106113056
92066;2015/09/05 00:00:00.000;2;2;0;0.0051000632;0.0005664398
92067;2015/09/05 00:00:00.000;32;29;3;0.170002108;0.0188813267
92069;2015/09/05 00:00:00.000;61;65;-4;0.1013212564;0.0112532707
92070;2015/09/05 00:00:00.000;1;1;0;0.0017000211;0.0001888133
92071;2015/09/05 00:00:00.000;60;50;10;0.1241015389;0.0137833685
92075;2015/09/05 00:00:00.000;24;25;-1;0.0686808516;0.007628056
92078;2015/09/05 00:00:00.000;102;89;13;0.1441617876;0.016011365
92081;2015/09/05 00:00:00.000;41;33;8;0.0707208769;0.0078546319
92082;2015/09/05 00:00:00.000;31;28;3;0.0520206451;0.005777686
92083;2015/09/05 00:00:00.000;32;25;7;0.0649408053;0.0072126668
92084;2015/09/05 00:00:00.000;64;64;0;0.0833010329;0.0092518501
92086;2015/09/05 00:00:00.000;13;12;1;0.0074800928;0.0008307784
92091;2015/09/05 00:00:00.000;24;21;3;0.0890811046;0.0098938152
92101;2015/09/05 00:00:00.000;92;82;10;0.1975424495;0.0219401016
92102;2015/09/05 00:00:00.000;35;27;8;0.1434817792;0.0159358397
92105;2015/09/05 00:00:00.000;28;23;5;0.0996212353;0.0110644575
92106;2015/09/05 00:00:00.000;46;40;6;0.1683020869;0.0186925134
92108;2015/09/05 00:00:00.000;37;30;7;0.089761113;0.0099693405
92109;2015/09/05 00:00:00.000;99;97;2;0.3553044058;0.0394619728
92113;2015/09/05 00:00:00.000;10;9;1;0.0554206872;0.0061553125
92114;2015/09/05 00:00:00.000;31;32;-1;0.1281815895;0.0142365203
92116;2015/09/05 00:00:00.000;45;39;6;0.1203614925;0.0133679793
92117;2015/09/05 00:00:00.000;61;52;9;0.1645620406;0.0182771243
92120;2015/09/05 00:00:00.000;51;47;4;0.1366816949;0.0151805867
92121;2015/09/05 00:00:00.000;5;5;0;0.0323004005;0.0035874521
92123;2015/09/05 00:00:00.000;24;25;-1;0.0894211088;0.0099315778
92124;2015/09/05 00:00:00.000;28;29;-1;0.09758121;0.0108378815
92127;2015/09/05 00:00:00.000;99;84;15;0.2505831072;0.0278310756
92128;2015/09/05 00:00:00.000;108;107;1;0.3043037734;0.0337975748
92203;2015/09/05 00:00:00.000;384;344;40;0.1122013913;0.0124616756
92210;2015/09/05 00:00:00.000;63;58;5;0.0261803246;0.0029077243
92211;2015/09/05 00:00:00.000;162;154;8;0.1482418382;0.0164645169
92220;2015/09/05 00:00:00.000;76;88;-12;0.0540606704;0.0060042619
92227;2015/09/05 00:00:00.000;18;15;3;0.0217602698;0.0024168098
92231;2015/09/05 00:00:00.000;15;16;-1;0.0275403415;0.0030587749
92236;2015/09/05 00:00:00.000;17;17;0;0.0234602909;0.0026056231
92239;2015/09/05 00:00:00.000;1;1;0;0.0003400042;0.0000377627
92242;2015/09/05 00:00:00.000;3;4;-1;0.0054400675;0.0006042025
92243;2015/09/05 00:00:00.000;47;41;6;0.0656208137;0.0072881921
92249;2015/09/05 00:00:00.000;3;3;0;0.0040800506;0.0004531518
92251;2015/09/05 00:00:00.000;18;19;-1;0.0278803457;0.0030965376
92252;2015/09/05 00:00:00.000;32;34;-2;0.0710608812;0.0078923946
92256;2015/09/05 00:00:00.000;11;14;-3;0.0319603963;0.0035496894
92260;2015/09/05 00:00:00.000;151;139;12;0.1914223736;0.0212603739
92264;2015/09/05 00:00:00.000;122;126;-4;0.3094038366;0.0343640146
92270;2015/09/05 00:00:00.000;160;164;-4;0.1635420279;0.0181638363
92276;2015/09/05 00:00:00.000;21;23;-2;0.017340215;0.0019258953
92280;2015/09/05 00:00:00.000;1;1;0;0.0017000211;0.0001888133
92284;2015/09/05 00:00:00.000;130;161;-31;0.1213815051;0.0134812673
92285;2015/09/05 00:00:00.000;21;21;0;0.0176802192;0.001963658
92301;2015/09/05 00:00:00.000;148;144;4;0.0421605228;0.004682569
92307;2015/09/05 00:00:00.000;120;126;-6;0.1706821165;0.018956852
92311;2015/09/05 00:00:00.000;55;54;1;0.0969012016;0.0107623562
92315;2015/09/05 00:00:00.000;90;96;-6;0.1570819478;0.0174463459
92316;2015/09/05 00:00:00.000;17;22;-5;0.0091801138;0.0010195916
92317;2015/09/05 00:00:00.000;1;1;0;0.0068000843;0.0007552531
92318;2015/09/05 00:00:00.000;1;2;-1;0.0003272037;0.000036346
92322;2015/09/05 00:00:00.000;8;9;-1;0.0030600379;0.0003398639
92325;2015/09/05 00:00:00.000;73;79;-6;0.1383817159;0.0153693999
92333;2015/09/05 00:00:00.000;11;10;1;0.0183602277;0.0020391833
92337;2015/09/05 00:00:00.000;32;34;-2;0.0496406155;0.0055133474
92341;2015/09/05 00:00:00.000;10;13;-3;0.0115601433;0.0012839302
92342;2015/09/05 00:00:00.000;45;48;-3;0.0357004427;0.0039650786
92344;2015/09/05 00:00:00.000;290;272;18;0.050320624;0.0055888727
92345;2015/09/05 00:00:00.000;124;129;-5;0.1411017497;0.0156715012
92352;2015/09/05 00:00:00.000;143;137;6;0.317903942;0.0353080809
92356;2015/09/05 00:00:00.000;24;26;-2;0.0207402572;0.0023035219
92359;2015/09/05 00:00:00.000;11;9;2;0.0061200759;0.0006797278
92363;2015/09/05 00:00:00.000;30;42;-12;0.0176802192;0.001963658
92365;2015/09/05 00:00:00.000;9;12;-3;0.007820097;0.000868541
92365;2015/07/04 00:00:00.000;7;8;-1;0.024592239;0.0026611753
92368;2015/07/04 00:00:00.000;3;3;0;0.0010849517;0.0001174048
92368;2015/09/05 00:00:00.000;3;3;0;0.0023800295;0.0002643386
92371;2015/07/04 00:00:00.000;41;40;1;0.0448446711;0.0048527313
92371;2015/09/05 00:00:00.000;46;53;-7;0.0302603752;0.0033608762
92372;2015/09/05 00:00:00.000;20;23;-3;0.0108801349;0.0012084049
92372;2015/07/04 00:00:00.000;19;17;2;0.0314635999;0.0034047389
92373;2015/07/04 00:00:00.000;66;68;-2;0.1157281834;0.0125231777
92373;2015/09/05 00:00:00.000;70;84;-14;0.1128813997;0.0125372009
92374;2015/09/05 00:00:00.000;53;56;-3;0.0741209191;0.0082322584
92374;2015/07/04 00:00:00.000;59;56;3;0.0918592456;0.0099402723
92376;2015/07/04 00:00:00.000;55;50;5;0.0748616687;0.0081009306
92376;2015/09/05 00:00:00.000;63;75;-12;0.0465805776;0.0051734835
92377;2015/07/04 00:00:00.000;22;20;2;0.0162742758;0.0017610719
92377;2015/09/05 00:00:00.000;19;21;-2;0.0244803036;0.002718911
92378;2015/07/04 00:00:00.000;3;3;0;0.002531554;0.0002739445
92378;2015/09/05 00:00:00.000;5;6;-1;0.0054400675;0.0006042025
92382;2015/09/05 00:00:00.000;88;80;8;0.0680008432;0.0075525307
92382;2015/07/04 00:00:00.000;58;51;7;0.0452063217;0.0048918663
92385;2015/07/04 00:00:00.000;1;1;0;0.0021699034;0.0002348096
92386;2015/09/05 00:00:00.000;17;3;14;0.0023800295;0.0002643386
92391;2015/09/05 00:00:00.000;22;23;-1;0.0302603752;0.0033608762
92391;2015/07/04 00:00:00.000;23;25;-2;0.0115728183;0.0012523178
92392;2015/07/04 00:00:00.000;102;105;-3;0.1667209143;0.0180412028
92392;2015/09/05 00:00:00.000;106;110;-4;0.1489218466;0.0165400422
92394;2015/07/04 00:00:00.000;70;69;1;0.0969223536;0.0104881613
92394;2015/09/05 00:00:00.000;95;98;-3;0.0690208559;0.0076658186
92395;2015/07/04 00:00:00.000;120;126;-6;0.1070485697;0.0115839393
92397;2015/07/04 00:00:00.000;27;29;-2;0.0343568045;0.0037178184
92397;2015/09/05 00:00:00.000;31;40;-9;0.0540606704;0.0060042619
92398;2015/09/05 00:00:00.000;3;3;0;0.0037400464;0.0004153892
92398;2015/07/04 00:00:00.000;6;6;0;0.007594662;0.0008218335
92399;2015/09/05 00:00:00.000;120;120;0;0.1737421544;0.0192967159
92401;2015/07/04 00:00:00.000;2;3;-1;0.0032548552;0.0003522144
92404;2015/09/05 00:00:00.000;67;76;-9;0.0448805565;0.0049846703
92404;2015/07/04 00:00:00.000;64;66;-2;0.054247586;0.0058702395
92405;2015/09/05 00:00:00.000;38;41;-3;0.032980409;0.0036629774
92405;2015/07/04 00:00:00.000;24;23;1;0.0354417562;0.0038352232
92407;2015/09/05 00:00:00.000;220;244;-24;0.0860210667;0.0095539513
92407;2015/07/04 00:00:00.000;107;86;21;0.0929441973;0.0100576771
92408;2015/09/05 00:00:00.000;9;9;0;0.0105401307;0.0011706423
92408;2015/07/04 00:00:00.000;7;5;2;0.0065097103;0.0007044287
92410;2015/07/04 00:00:00.000;33;35;-2;0.0285703953;0.0030916595
92410;2015/09/05 00:00:00.000;26;33;-7;0.0343404258;0.003814028
92411;2015/07/04 00:00:00.000;16;16;0;0.0184441792;0.0019958814
92501;2015/09/05 00:00:00.000;26;26;0;0.0567807041;0.0063063631
92503;2015/09/05 00:00:00.000;112;104;8;0.1142414166;0.0126882515
92503;2015/07/04 00:00:00.000;91;81;10;0.1189830386;0.012875392
92504;2015/09/05 00:00:00.000;63;74;-11;0.0734409107;0.0081567331
92505;2015/07/04 00:00:00.000;41;33;8;0.0632888503;0.0068486128
92505;2015/09/05 00:00:00.000;46;51;-5;0.0720808938;0.0080056825
92506;2015/07/04 00:00:00.000;91;96;-5;0.148276735;0.0160453214
92506;2015/09/05 00:00:00.000;121;119;2;0.1472218256;0.0163512289
92507;2015/09/05 00:00:00.000;62;67;-5;0.0884010962;0.0098182899
92508;2015/07/04 00:00:00.000;48;44;4;0.1182597374;0.0127971222
92508;2015/09/05 00:00:00.000;58;64;-6;0.0686808516;0.007628056
92509;2015/07/04 00:00:00.000;56;55;1;0.1099417743;0.0118970188
92509;2015/09/05 00:00:00.000;79;90;-11;0.1016612606;0.0112910334
92530;2015/09/05 00:00:00.000;104;110;-6;0.1941424074;0.0215624751
92532;2015/07/04 00:00:00.000;79;71;8;0.078839825;0.0085314148
92536;2015/09/05 00:00:00.000;13;16;-3;0.017340215;0.0019258953
92539;2015/09/05 00:00:00.000;14;13;1;0.0132601644;0.0014727435
92539;2015/07/04 00:00:00.000;10;10;0;0.0249538896;0.0027003102
92543;2015/07/04 00:00:00.000;73;65;8;0.0697985606;0.0075530415
92544;2015/07/04 00:00:00.000;98;100;-2;0.1175364363;0.0127188523
92544;2015/09/05 00:00:00.000;144;154;-10;0.1251215515;0.0138966565
92545;2015/09/05 00:00:00.000;153;161;-8;0.1417817581;0.0157470265
92545;2015/07/04 00:00:00.000;87;95;-8;0.0893276916;0.0096663278
92548;2015/07/04 00:00:00.000;16;20;-4;0.0079563126;0.0008609685
92548;2015/09/05 00:00:00.000;10;8;2;0.0074800928;0.0008307784
92549;2015/09/05 00:00:00.000;88;89;-1;0.1166214461;0.0129525901
92551;2015/07/04 00:00:00.000;41;39;2;0.0499077791;0.0054006204
92551;2015/09/05 00:00:00.000;31;33;-2;0.0353604385;0.003927316
92553;2015/07/04 00:00:00.000;50;48;2;0.0538859354;0.0058311046
92553;2015/09/05 00:00:00.000;46;49;-3;0.0584807252;0.0064951764
92555;2015/07/04 00:00:00.000;60;58;2;0.0900509927;0.0097445976
92555;2015/09/05 00:00:00.000;72;79;-7;0.0785409739;0.0087231729
92557;2015/07/04 00:00:00.000;71;72;-1;0.1146432317;0.0124057729
92561;2015/07/04 00:00:00.000;23;28;-5;0.0126577701;0.0013697226
92561;2015/09/05 00:00:00.000;14;14;0;0.0119001476;0.0013216929
92562;2015/07/04 00:00:00.000;192;171;21;0.2195218979;0.0237549026
92562;2015/09/05 00:00:00.000;167;177;-10;0.2431030145;0.0270002972
92563;2015/09/05 00:00:00.000;132;146;-14;0.2213427447;0.0245834874
92563;2015/07/04 00:00:00.000;130;126;4;0.1696141188;0.0183542823
92567;2015/09/05 00:00:00.000;14;15;-1;0.0057800717;0.0006419651
92567;2015/07/04 00:00:00.000;17;13;4;0.0126577701;0.0013697226
92570;2015/07/04 00:00:00.000;63;59;4;0.0896893422;0.0097054627
92570;2015/09/05 00:00:00.000;76;87;-11;0.0584807252;0.0064951764
92571;2015/07/04 00:00:00.000;47;42;5;0.0658204043;0.0071225573
92582;2015/07/04 00:00:00.000;32;31;1;0.0307402987;0.0033264691
92584;2015/09/05 00:00:00.000;137;139;-2;0.1621820111;0.0180127857
92585;2015/07/04 00:00:00.000;60;58;2;0.0437597194;0.0047353266
92585;2015/09/05 00:00:00.000;70;78;-8;0.0595007378;0.0066084643
92586;2015/07/04 00:00:00.000;91;72;19;0.0745000181;0.0080617956
92586;2015/09/05 00:00:00.000;128;157;-29;0.0574607125;0.0063818884
92587;2015/09/05 00:00:00.000;86;74;12;0.0404605017;0.0044937558
92590;2015/07/04 00:00:00.000;13;11;2;0.0412281653;0.004461382
92590;2015/09/05 00:00:00.000;13;16;-3;0.0486206029;0.0054000594
92591;2015/09/05 00:00:00.000;96;104;-8;0.190402361;0.0211470859
92592;2015/09/05 00:00:00.000;218;216;2;0.3709445997;0.0411990549
92595;2015/07/04 00:00:00.000;79;69;10;0.0513543814;0.0055571601
92596;2015/09/05 00:00:00.000;69;72;-3;0.042500527;0.0047203317
92602;2015/09/05 00:00:00.000;35;40;-5;0.0421605228;0.004682569
92602;2015/07/04 00:00:00.000;35;36;-1;0.0614805974;0.0066529381
92603;2015/09/05 00:00:00.000;45;50;-5;0.0972412058;0.0108001189
92604;2015/07/04 00:00:00.000;47;40;7;0.0575024411;0.0062224539
92604;2015/09/05 00:00:00.000;51;54;-3;0.085001054;0.0094406634
92606;2015/09/05 00:00:00.000;24;36;-12;0.0306003794;0.0033986388
92610;2015/09/05 00:00:00.000;19;23;-4;0.0170002108;0.0018881327
92610;2015/07/04 00:00:00.000;21;16;5;0.0238689378;0.0025829054
92612;2015/09/05 00:00:00.000;70;77;-7;0.0659608179;0.0073259548
92612;2015/07/04 00:00:00.000;61;57;4;0.0661820549;0.0071616922
92614;2015/07/04 00:00:00.000;32;34;-2;0.0665437055;0.0072008272
92618;2015/07/04 00:00:00.000;44;37;7;0.0828179813;0.008961899
92618;2015/09/05 00:00:00.000;79;85;-6;0.1234215304;0.0137078432
92625;2015/09/05 00:00:00.000;59;59;0;0.1577619562;0.0175218712
92626;2015/09/05 00:00:00.000;51;59;-8;0.0795609866;0.0088364609
92626;2015/07/04 00:00:00.000;36;29;7;0.0629271997;0.0068094779
92627;2015/09/05 00:00:00.000;86;87;-1;0.1363416906;0.015142824
92627;2015/07/04 00:00:00.000;67;66;1;0.1294709052;0.014010305
92629;2015/07/04 00:00:00.000;66;69;-3;0.1685291671;0.0182368775
92630;2015/07/04 00:00:00.000;89;92;-3;0.0994539076;0.0107621058
92630;2015/09/05 00:00:00.000;107;123;-16;0.1145814208;0.0127260142
92637;2015/09/05 00:00:00.000;72;82;-10;0.1098213618;0.0121973371
92637;2015/07/04 00:00:00.000;79;84;-5;0.1450218799;0.015693107
92647;2015/07/04 00:00:00.000;46;41;5;0.1016238111;0.0109969154
92647;2015/09/05 00:00:00.000;57;55;2;0.1030212775;0.011442084
92648;2015/07/04 00:00:00.000;86;81;5;0.202524321;0.0219155609
92648;2015/09/05 00:00:00.000;123;136;-13;0.1489218466;0.0165400422
92649;2015/09/05 00:00:00.000;72;71;1;0.1074413323;0.0119329985
92651;2015/07/04 00:00:00.000;130;117;13;0.3960073777;0.0428527486
92653;2015/09/05 00:00:00.000;83;75;8;0.0890811046;0.0098938152
92653;2015/07/04 00:00:00.000;79;72;7;0.0867961376;0.0093923832
92655;2015/09/05 00:00:00.000;4;5;-1;0.0034000422;0.0003776265
92656;2015/07/04 00:00:00.000;202;189;13;0.1475534339;0.0159670515
92656;2015/09/05 00:00:00.000;266;278;-12;0.147901834;0.0164267542
92657;2015/07/04 00:00:00.000;76;68;8;0.1218762432;0.0131884715
92661;2015/09/05 00:00:00.000;13;13;0;0.0520206451;0.005777686
92662;2015/09/05 00:00:00.000;5;5;0;0.0142801771;0.0015860314
92662;2015/07/04 00:00:00.000;6;4;2;0.0292936964;0.0031699293
92663;2015/07/04 00:00:00.000;71;70;1;0.1370655672;0.0148321385
92663;2015/09/05 00:00:00.000;70;73;-3;0.1632020237;0.0181260736
92672;2015/07/04 00:00:00.000;67;59;8;0.1743155763;0.0188630364
92673;2015/09/05 00:00:00.000;81;93;-12;0.1125413955;0.0124994383
92673;2015/07/04 00:00:00.000;89;81;8;0.123684496;0.0133841461
92675;2015/09/05 00:00:00.000;74;78;-4;0.1509618719;0.0167666181
92675;2015/07/04 00:00:00.000;85;78;7;0.1367039167;0.0147930036
92676;2015/09/05 00:00:00.000;15;13;2;0.0142801771;0.0015860314
92676;2015/07/04 00:00:00.000;2;3;-1;0.0104878666;0.001134913
92677;2015/09/05 00:00:00.000;228;228;0;0.3260640432;0.0362143846
92679;2015/09/05 00:00:00.000;356;356;0;0.0680008432;0.0075525307
92679;2015/07/04 00:00:00.000;452;408;44;0.1197063397;0.0129536619
92691;2015/07/04 00:00:00.000;86;89;-3;0.1254927489;0.0135798208
92692;2015/09/05 00:00:00.000;130;121;9;0.1278415852;0.0141987577
92694;2015/07/04 00:00:00.000;336;296;40;0.1359806155;0.0147147338
92701;2015/07/04 00:00:00.000;22;21;1;0.0318252504;0.0034438739
92703;2015/09/05 00:00:00.000;28;32;-4;0.0336604174;0.0037385027
92704;2015/09/05 00:00:00.000;53;54;-1;0.064600801;0.0071749041
92705;2015/09/05 00:00:00.000;73;85;-12;0.1128813997;0.0125372009
92705;2015/07/04 00:00:00.000;80;78;2;0.1200679903;0.0129927968
92706;2015/07/04 00:00:00.000;24;24;0;0.0376116596;0.0040700327
92707;2015/09/05 00:00:00.000;31;37;-6;0.0309403837;0.0034364015
92708;2015/07/04 00:00:00.000;55;51;4;0.0878810893;0.009509788
92708;2015/09/05 00:00:00.000;54;58;-4;0.0799009908;0.0088742236
92782;2015/09/05 00:00:00.000;51;51;0;0.0693608601;0.0077035813
92782;2015/07/04 00:00:00.000;55;55;0;0.0676286572;0.0073182319
92802;2015/07/04 00:00:00.000;14;14;0;0.0253155401;0.0027394451
92804;2015/09/05 00:00:00.000;46;53;-7;0.0683408474;0.0075902933
92805;2015/07/04 00:00:00.000;32;38;-6;0.0647354526;0.0070051525
92806;2015/07/04 00:00:00.000;26;25;1;0.0329102022;0.0035612786
92806;2015/09/05 00:00:00.000;26;29;-3;0.0384204764;0.0042671798
92807;2015/09/05 00:00:00.000;58;61;-3;0.0782009697;0.0086854103
92808;2015/07/04 00:00:00.000;52;49;3;0.0708835124;0.0076704463
92821;2015/07/04 00:00:00.000;49;57;-8;0.0716068135;0.0077487162
92823;2015/09/05 00:00:00.000;8;11;-3;0.0153001897;0.0016993194
92831;2015/07/04 00:00:00.000;24;26;-2;0.0535242848;0.0057919697
92833;2015/09/05 00:00:00.000;75;72;3;0.0601807462;0.0066839897
92835;2015/07/04 00:00:00.000;38;43;-5;0.0535242848;0.0057919697
92840;2015/07/04 00:00:00.000;30;28;2;0.027123793;0.0029351198
92841;2015/07/04 00:00:00.000;16;14;2;0.0213373838;0.0023089609
92843;2015/09/05 00:00:00.000;23;21;2;0.0374004638;0.0041538919
92845;2015/07/04 00:00:00.000;10;13;-3;0.0159126252;0.0017219369
92860;2015/09/05 00:00:00.000;60;66;-6;0.0394404891;0.0043804678
92861;2015/09/05 00:00:00.000;13;17;-4;0.0190402361;0.0021147086
92867;2015/07/04 00:00:00.000;35;38;-3;0.0585873929;0.0063398587
92868;2015/07/04 00:00:00.000;13;12;1;0.0231456367;0.0025046355
92868;2015/09/05 00:00:00.000;19;17;2;0.0302603752;0.0033608762
92869;2015/09/05 00:00:00.000;53;68;-15;0.1135614082;0.0126127262
92870;2015/07/04 00:00:00.000;56;63;-7;0.0596723446;0.0064572635
92879;2015/07/04 00:00:00.000;59;57;2;0.1074102202;0.0116230743
92880;2015/07/04 00:00:00.000;114;117;-3;0.1464684822;0.0158496467
92880;2015/09/05 00:00:00.000;122;137;-15;0.1254615557;0.0139344191
92881;2015/09/05 00:00:00.000;64;71;-7;0.0836410371;0.0092896127
92883;2015/07/04 00:00:00.000;109;108;1;0.1171747857;0.0126797174
92883;2015/09/05 00:00:00.000;106;108;-2;0.0972412058;0.0108001189
93001;2015/07/04 00:00:00.000;41;33;8;0.1352573144;0.0146364639
93001;2015/09/05 00:00:00.000;41;37;4;0.114921425;0.0127637769
93003;2015/09/05 00:00:00.000;68;60;8;0.1009812522;0.0112155081
93004;2015/09/05 00:00:00.000;33;34;-1;0.0554206872;0.0061553125
93010;2015/07/04 00:00:00.000;61;49;12;0.091497595;0.0099011373
93010;2015/09/05 00:00:00.000;81;75;6;0.0778609655;0.0086476476
93013;2015/07/04 00:00:00.000;19;19;0;0.0654587538;0.0070834224
93015;2015/09/05 00:00:00.000;24;21;3;0.0302603752;0.0033608762
93021;2015/09/05 00:00:00.000;84;80;4;0.0758209402;0.0084210717
93022;2015/07/04 00:00:00.000;8;8;0;0.0036165057;0.0003913493
93023;2015/07/04 00:00:00.000;42;37;5;0.108495172;0.0117404791
93030;2015/09/05 00:00:00.000;29;30;-1;0.0418205186;0.0046448064
93030;2015/07/04 00:00:00.000;26;18;8;0.0470145745;0.0050875409
93035;2015/09/05 00:00:00.000;73;79;-6;0.1298816105;0.0144253336
93035;2015/07/04 00:00:00.000;82;76;6;0.121152942;0.0131102016
93041;2015/07/04 00:00:00.000;31;28;3;0.0535242848;0.0057919697
93060;2015/07/04 00:00:00.000;21;26;-5;0.022060685;0.0023872307
93063;2015/09/05 00:00:00.000;99;93;6;0.1193414798;0.0132546913
93065;2015/07/04 00:00:00.000;103;98;5;0.1844417923;0.0199588144
93066;2015/09/05 00:00:00.000;8;12;-4;0.0088401096;0.000981829
93067;2015/09/05 00:00:00.000;1;1;0;0.0231202867;0.0025678604
93101;2015/09/05 00:00:00.000;26;22;4;0.0952011805;0.010573543
93103;2015/09/05 00:00:00.000;26;18;8;0.1030212775;0.011442084
93103;2015/07/04 00:00:00.000;16;13;3;0.0723301146;0.007826986
93105;2015/09/05 00:00:00.000;41;36;5;0.1492618508;0.0165778048
93108;2015/07/04 00:00:00.000;62;52;10;0.2090340313;0.0226199897
93108;2015/09/05 00:00:00.000;86;76;10;0.1978824537;0.0219778643
93109;2015/07/04 00:00:00.000;10;12;-2;0.0264004918;0.0028568499
93110;2015/09/05 00:00:00.000;24;25;-1;0.1077813365;0.0119707611
93111;2015/07/04 00:00:00.000;15;20;-5;0.0719684641;0.0077878511
93111;2015/09/05 00:00:00.000;12;13;-1;0.0353604385;0.003927316
93117;2015/09/05 00:00:00.000;26;27;-1;0.09758121;0.0108378815
93202;2015/09/05 00:00:00.000;2;2;0;0.0003400042;0.0000377627
93203;2015/09/05 00:00:00.000;5;2;3;0.0088401096;0.000981829
93204;2015/09/05 00:00:00.000;3;2;1;0.0006800084;0.0000755253
93205;2015/09/05 00:00:00.000;12;14;-2;0.0054400675;0.0006042025
93205;2015/07/04 00:00:00.000;6;7;-1;0.0039781563;0.0004304842
93206;2015/07/04 00:00:00.000;2;1;1;0.0014466023;0.0001565397
93210;2015/09/05 00:00:00.000;13;11;2;0.0057800717;0.0006419651
93210;2015/07/04 00:00:00.000;9;10;-1;0.0180825287;0.0019567465
93212;2015/09/05 00:00:00.000;8;11;-3;0.0074800928;0.0008307784
93215;2015/09/05 00:00:00.000;17;13;4;0.0176802192;0.001963658
93215;2015/07/04 00:00:00.000;6;7;-1;0.0159126252;0.0017219369
93219;2015/09/05 00:00:00.000;1;1;0;0.0034000422;0.0003776265
93221;2015/07/04 00:00:00.000;13;13;0;0.0112111678;0.0012131828
93222;2015/07/04 00:00:00.000;1;1;0;0.0083179632;0.0009001034
93223;2015/09/05 00:00:00.000;3;3;0;0.0020400253;0.0002265759
93225;2015/07/04 00:00:00.000;57;51;6;0.0484611768;0.0052440806
93225;2015/09/05 00:00:00.000;65;106;-41;0.042500527;0.0047203317
93226;2015/09/05 00:00:00.000;2;1;1;0.0026176297;0.0002907681
93230;2015/09/05 00:00:00.000;69;75;-6;0.1312416274;0.0145763842
93230;2015/07/04 00:00:00.000;72;72;0;0.1312791581;0.0142059797
93234;2015/09/05 00:00:00.000;1;1;0;0.0006800084;0.0000755253
93235;2015/09/05 00:00:00.000;2;2;0;0.0006800084;0.0000755253
93235;2015/07/04 00:00:00.000;1;1;0;0.002531554;0.0002739445
93239;2015/07/04 00:00:00.000;2;2;0;0.0007233011;0.0000782699
93240;2015/09/05 00:00:00.000;54;56;-2;0.0333204132;0.00370074
93240;2015/07/04 00:00:00.000;24;20;4;0.0235072873;0.0025437705
93242;2015/09/05 00:00:00.000;1;1;0;0.0030600379;0.0003398639
93243;2015/09/05 00:00:00.000;4;6;-2;0.0037400464;0.0004153892
93245;2015/09/05 00:00:00.000;21;25;-4;0.0374004638;0.0041538919
93245;2015/07/04 00:00:00.000;18;19;-1;0.0379733102;0.0041091677
93247;2015/09/05 00:00:00.000;9;9;0;0.0071400885;0.0007930157
93247;2015/07/04 00:00:00.000;7;9;-2;0.0101262161;0.001095778
93249;2015/09/05 00:00:00.000;1;1;0;0.0010200126;0.000113288
93250;2015/09/05 00:00:00.000;4;2;2;0.0044200548;0.0004909145
93252;2015/07/04 00:00:00.000;1;1;0;0.0014466023;0.0001565397
93254;2015/07/04 00:00:00.000;1;1;0;0.0010849517;0.0001174048
93255;2015/09/05 00:00:00.000;2;1;1;0.0030600379;0.0003398639
93256;2015/09/05 00:00:00.000;3;3;0;0.0030600379;0.0003398639
93257;2015/07/04 00:00:00.000;33;30;3;0.094029149;0.0101750819
93260;2015/09/05 00:00:00.000;1;1;0;0.0037400464;0.0004153892
93263;2015/09/05 00:00:00.000;11;11;0;0.0108801349;0.0012084049
93265;2015/09/05 00:00:00.000;4;5;-1;0.0112201391;0.0012461676
93265;2015/07/04 00:00:00.000;4;4;0;0.0122961195;0.0013305876
93267;2015/09/05 00:00:00.000;3;1;2;0.004760059;0.0005286771
93268;2015/09/05 00:00:00.000;21;24;-3;0.0312803879;0.0034741641
93271;2015/07/04 00:00:00.000;6;5;1;0.0126577701;0.0013697226
93274;2015/09/05 00:00:00.000;57;59;-2;0.072420898;0.0080434452
93277;2015/09/05 00:00:00.000;67;68;-1;0.100641248;0.0111777454
93277;2015/07/04 00:00:00.000;80;85;-5;0.0936674985;0.0101359469
93280;2015/09/05 00:00:00.000;9;11;-2;0.0105401307;0.0011706423
93280;2015/07/04 00:00:00.000;8;7;1;0.0079563126;0.0008609685
93283;2015/09/05 00:00:00.000;21;22;-1;0.0112201391;0.0012461676
93285;2015/09/05 00:00:00.000;42;42;0;0.0098601223;0.0010951169
93286;2015/09/05 00:00:00.000;5;5;0;0.0091801138;0.0010195916
93291;2015/09/05 00:00:00.000;81;76;5;0.0914611341;0.0101581538
93292;2015/09/05 00:00:00.000;49;47;2;0.0591607336;0.0065707017
93301;2015/07/04 00:00:00.000;9;10;-1;0.0285703953;0.0030916595
93305;2015/07/04 00:00:00.000;28;25;3;0.0329102022;0.0035612786
93306;2015/09/05 00:00:00.000;136;124;12;0.1237615346;0.0137456058
93306;2015/07/04 00:00:00.000;119;118;1;0.1623811074;0.0175715837
93307;2015/09/05 00:00:00.000;52;46;6;0.0812610076;0.0090252742
93308;2015/07/04 00:00:00.000;50;50;0;0.1124733283;0.0121709633
93308;2015/09/05 00:00:00.000;91;88;3;0.0948611763;0.0105357803
93309;2015/09/05 00:00:00.000;91;86;5;0.1543619141;0.0171442447
93309;2015/07/04 00:00:00.000;68;56;12;0.1233228455;0.0133450112
93311;2015/09/05 00:00:00.000;162;130;32;0.1853022977;0.0205806461
93312;2015/09/05 00:00:00.000;170;147;23;0.1642220364;0.0182393616
93313;2015/07/04 00:00:00.000;72;69;3;0.1045170157;0.0113099948
93314;2015/07/04 00:00:00.000;93;93;0;0.083902933;0.0090793038
93314;2015/09/05 00:00:00.000;137;126;11;0.1196814841;0.013292454
93401;2015/09/05 00:00:00.000;40;42;-2;0.1261415642;0.0140099444
93401;2015/07/04 00:00:00.000;44;44;0;0.1634660591;0.0176889884
93402;2015/07/04 00:00:00.000;28;27;1;0.0509927308;0.0055180252
93405;2015/09/05 00:00:00.000;22;22;0;0.0618807673;0.0068728029
93422;2015/09/05 00:00:00.000;63;64;-1;0.0836410371;0.0092896127
93426;2015/09/05 00:00:00.000;6;8;-2;0.0071400885;0.0007930157
93427;2015/09/05 00:00:00.000;13;10;3;0.0112201391;0.0012461676
93428;2015/09/05 00:00:00.000;36;44;-8;0.0632407842;0.0070238535
93430;2015/09/05 00:00:00.000;23;23;0;0.0394404891;0.0043804678
93433;2015/09/05 00:00:00.000;27;32;-5;0.0578007167;0.0064196511
93434;2015/09/05 00:00:00.000;2;2;0;0.0023800295;0.0002643386
93436;2015/09/05 00:00:00.000;43;50;-7;0.1152614292;0.0128015395
93440;2015/09/05 00:00:00.000;2;1;1;0.004760059;0.0005286771
93444;2015/09/05 00:00:00.000;50;47;3;0.067660839;0.007514768
93445;2015/09/05 00:00:00.000;14;17;-3;0.0183602277;0.0020391833
93449;2015/09/05 00:00:00.000;26;29;-3;0.0833010329;0.0092518501
93451;2015/09/05 00:00:00.000;14;18;-4;0.0102001265;0.0011328796
93452;2015/09/05 00:00:00.000;3;3;0;0.0017000211;0.0001888133
93453;2015/09/05 00:00:00.000;7;6;1;0.0057800717;0.0006419651
93455;2015/09/05 00:00:00.000;78;77;1;0.1560619352;0.0173330579
93460;2015/09/05 00:00:00.000;8;9;-1;0.0360404469;0.0040028413
93465;2015/09/05 00:00:00.000;26;28;-2;0.0476005902;0.0052867715
93510;2015/09/05 00:00:00.000;25;28;-3;0.0350204343;0.0038895533
93512;2015/09/05 00:00:00.000;1;1;0;0.0013600169;0.0001510506
93516;2015/09/05 00:00:00.000;3;4;-1;0.004760059;0.0005286771
93517;2015/09/05 00:00:00.000;4;4;0;0.0051000632;0.0005664398
93518;2015/09/05 00:00:00.000;15;17;-2;0.007820097;0.000868541
93523;2015/09/05 00:00:00.000;2;2;0;0.0003400042;0.0000377627
93527;2015/09/05 00:00:00.000;14;14;0;0.0051000632;0.0005664398
93531;2015/09/05 00:00:00.000;5;5;0;0.0017000211;0.0001888133
93532;2015/09/05 00:00:00.000;32;24;8;0.0098601223;0.0010951169
93541;2015/09/05 00:00:00.000;1;1;0;0.0010200126;0.000113288
93543;2015/09/05 00:00:00.000;21;24;-3;0.0088401096;0.000981829
93544;2015/09/05 00:00:00.000;2;1;1;0.0030600379;0.0003398639
93545;2015/09/05 00:00:00.000;12;11;1;0.0037400464;0.0004153892
93546;2015/09/05 00:00:00.000;126;118;8;0.0904411215;0.0100448658
93550;2015/09/05 00:00:00.000;77;75;2;0.1482418382;0.0164645169
93551;2015/09/05 00:00:00.000;242;251;-9;0.2193027194;0.0243569115
93555;2015/09/05 00:00:00.000;119;123;-4;0.080240995;0.0089119862
93560;2015/09/05 00:00:00.000;22;23;-1;0.0309403837;0.0034364015
93562;2015/09/05 00:00:00.000;9;9;0;0.0017000211;0.0001888133
93591;2015/09/05 00:00:00.000;42;40;2;0.0231202867;0.0025678604
93602;2015/09/05 00:00:00.000;10;10;0;0.0068000843;0.0007552531
93609;2015/09/05 00:00:00.000;1;1;0;0.0027200337;0.0003021012
93611;2015/09/05 00:00:00.000;79;75;4;0.1241015389;0.0137833685
93612;2015/09/05 00:00:00.000;24;19;5;0.0520206451;0.005777686
93614;2015/09/05 00:00:00.000;54;54;0;0.0442005481;0.0049091449
93615;2015/09/05 00:00:00.000;1;2;-1;0.0013600169;0.0001510506
93620;2015/09/05 00:00:00.000;2;2;0;0.0037400464;0.0004153892
93623;2015/09/05 00:00:00.000;3;3;0;0.004760059;0.0005286771
93625;2015/09/05 00:00:00.000;3;4;-1;0.0040800506;0.0004531518
93630;2015/09/05 00:00:00.000;7;8;-1;0.0258403204;0.0028699617
93631;2015/09/05 00:00:00.000;13;10;3;0.0115601433;0.0012839302
93634;2015/09/05 00:00:00.000;2;2;0;0.0017000211;0.0001888133
93635;2015/09/05 00:00:00.000;49;51;-2;0.072420898;0.0080434452
93636;2015/09/05 00:00:00.000;18;20;-2;0.0207402572;0.0023035219
93637;2015/09/05 00:00:00.000;27;29;-2;0.0261803246;0.0029077243
93638;2015/09/05 00:00:00.000;23;25;-2;0.022100274;0.0024545725
93641;2015/09/05 00:00:00.000;1;1;0;0.0003400042;0.0000377627
93643;2015/09/05 00:00:00.000;11;12;-1;0.0040800506;0.0004531518
93644;2015/09/05 00:00:00.000;22;33;-11;0.0608607547;0.006759515
93647;2015/09/05 00:00:00.000;2;2;0;0.004760059;0.0005286771
93648;2015/09/05 00:00:00.000;1;1;0;0.0037400464;0.0004153892
93651;2015/09/05 00:00:00.000;4;3;1;0.0010200126;0.000113288
93653;2015/09/05 00:00:00.000;2;2;0;0.0040800506;0.0004531518
93654;2015/09/05 00:00:00.000;16;12;4;0.0108801349;0.0012084049
93656;2015/09/05 00:00:00.000;2;2;0;0.0068000843;0.0007552531
93657;2015/09/05 00:00:00.000;24;30;-6;0.0306003794;0.0033986388
93662;2015/09/05 00:00:00.000;18;19;-1;0.0085001054;0.0009440663
93664;2015/09/05 00:00:00.000;24;25;-1;0.0319603963;0.0035496894
93667;2015/09/05 00:00:00.000;3;6;-3;0.0040800506;0.0004531518
93668;2015/09/05 00:00:00.000;1;1;0;0.0010200126;0.000113288
93669;2015/09/05 00:00:00.000;5;7;-2;0.0010200126;0.000113288
93675;2015/09/05 00:00:00.000;7;5;2;0.0027200337;0.0003021012
93701;2015/09/05 00:00:00.000;3;3;0;0.0091801138;0.0010195916
93702;2015/09/05 00:00:00.000;15;17;-2;0.0282203499;0.0031343002
93703;2015/09/05 00:00:00.000;23;21;2;0.0258403204;0.0028699617
93704;2015/09/05 00:00:00.000;45;48;-3;0.0581407209;0.0064574137
93705;2015/09/05 00:00:00.000;40;41;-1;0.0567807041;0.0063063631
93706;2015/09/05 00:00:00.000;12;13;-1;0.0238002951;0.0026433857
93720;2015/09/05 00:00:00.000;63;60;3;0.1485818424;0.0165022795
93722;2015/09/05 00:00:00.000;99;99;0;0.1183214672;0.0131414034
93723;2015/09/05 00:00:00.000;28;27;1;0.0149601855;0.0016615568
93725;2015/09/05 00:00:00.000;15;17;-2;0.0108801349;0.0012084049
93726;2015/09/05 00:00:00.000;31;29;2;0.0353604385;0.003927316
93730;2015/09/05 00:00:00.000;30;29;1;0.0537206661;0.0059664992
93901;2015/09/05 00:00:00.000;29;24;5;0.0564406999;0.0062686005
93906;2015/09/05 00:00:00.000;33;38;-5;0.0778609655;0.0086476476
93907;2015/09/05 00:00:00.000;14;12;2;0.0564406999;0.0062686005
93926;2015/09/05 00:00:00.000;7;6;1;0.0027200337;0.0003021012
93927;2015/09/05 00:00:00.000;7;6;1;0.0115601433;0.0012839302
93930;2015/09/05 00:00:00.000;8;7;1;0.0088401096;0.000981829
93940;2015/09/05 00:00:00.000;54;54;0;0.253303141;0.0281331768
93950;2015/09/05 00:00:00.000;13;17;-4;0.0727609022;0.0080812078
93955;2015/09/05 00:00:00.000;22;18;4;0.0516806408;0.0057399233
93960;2015/09/05 00:00:00.000;11;10;1;0.0105401307;0.0011706423
94002;2015/09/05 00:00:00.000;10;14;-4;0.080240995;0.0089119862
94015;2015/09/05 00:00:00.000;29;28;1;0.0567807041;0.0063063631
94020;2015/09/05 00:00:00.000;3;3;0;0.0343404258;0.003814028
94024;2015/09/05 00:00:00.000;20;22;-2;0.0465805776;0.0051734835
94025;2015/09/05 00:00:00.000;23;21;2;0.117981463;0.0131036407
94027;2015/09/05 00:00:00.000;8;7;1;0.0914611341;0.0101581538
94040;2015/09/05 00:00:00.000;11;14;-3;0.0710608812;0.0078923946
94041;2015/09/05 00:00:00.000;3;7;-4;0.0272003373;0.0030210123
94043;2015/09/05 00:00:00.000;18;15;3;0.1067613238;0.0118574732
94060;2015/09/05 00:00:00.000;1;2;-1;0.0112201391;0.0012461676
94061;2015/09/05 00:00:00.000;10;13;-3;0.088061092;0.0097805272
94063;2015/09/05 00:00:00.000;9;6;3;0.0656208137;0.0072881921
94070;2015/09/05 00:00:00.000;17;16;1;0.09758121;0.0108378815
94080;2015/09/05 00:00:00.000;25;21;4;0.1295416063;0.014387571
94085;2015/09/05 00:00:00.000;12;12;0;0.0516806408;0.0057399233
94087;2015/09/05 00:00:00.000;22;26;-4;0.0955411847;0.0106113056
94089;2015/09/05 00:00:00.000;30;33;-3;0.0986012227;0.0109511695
94102;2015/09/05 00:00:00.000;9;12;-3;0.0931611552;0.010346967
94103;2015/09/05 00:00:00.000;11;10;1;0.1332816527;0.0148029601
94105;2015/09/05 00:00:00.000;21;18;3;0.1356616822;0.0150672987
94107;2015/09/05 00:00:00.000;18;25;-7;0.1584419647;0.0175973965
94108;2015/09/05 00:00:00.000;2;1;1;0.1098213618;0.0121973371
94112;2015/09/05 00:00:00.000;27;25;2;0.2138626519;0.023752709
94114;2015/09/05 00:00:00.000;12;12;0;0.1955024242;0.0217135257
94118;2015/09/05 00:00:00.000;8;10;-2;0.1118613871;0.012423913
94121;2015/09/05 00:00:00.000;10;9;1;0.0989412269;0.0109889321
94123;2015/09/05 00:00:00.000;8;6;2;0.1482418382;0.0164645169
94124;2015/09/05 00:00:00.000;11;13;-2;0.0765009486;0.008496597
94127;2015/09/05 00:00:00.000;10;9;1;0.0652808095;0.0072504295
94132;2015/09/05 00:00:00.000;12;10;2;0.0686808516;0.007628056
94133;2015/09/05 00:00:00.000;3;3;0;0.0761609444;0.0084588344
94158;2015/09/05 00:00:00.000;4;3;1;0.0156401939;0.0017370821
94301;2015/09/05 00:00:00.000;9;7;2;0.0659608179;0.0073259548
94303;2015/09/05 00:00:00.000;40;42;-2;0.0894211088;0.0099315778
94306;2015/09/05 00:00:00.000;8;11;-3;0.0669808306;0.0074392427
94401;2015/09/05 00:00:00.000;18;20;-2;0.072420898;0.0080434452
94402;2015/09/05 00:00:00.000;15;9;6;0.117981463;0.0131036407
94403;2015/09/05 00:00:00.000;29;32;-3;0.1421217623;0.0157847891
94404;2015/09/05 00:00:00.000;40;44;-4;0.0853410582;0.009478426
94501;2015/09/05 00:00:00.000;30;27;3;0.2128426392;0.023639421
94502;2015/09/05 00:00:00.000;10;7;3;0.0564406999;0.0062686005
94503;2015/09/05 00:00:00.000;22;17;5;0.0319603963;0.0035496894
94505;2015/09/05 00:00:00.000;51;43;8;0.0567807041;0.0063063631
94506;2015/09/05 00:00:00.000;58;46;12;0.0986012227;0.0109511695
94507;2015/09/05 00:00:00.000;35;36;-1;0.0799009908;0.0088742236
94517;2015/09/05 00:00:00.000;20;18;2;0.0520206451;0.005777686
94518;2015/09/05 00:00:00.000;46;38;8;0.0999612395;0.0111022201
94519;2015/09/05 00:00:00.000;30;28;2;0.0595007378;0.0066084643
94523;2015/09/05 00:00:00.000;44;42;2;0.143141775;0.0158980771
94525;2015/09/05 00:00:00.000;3;3;0;0.004760059;0.0005286771
94526;2015/09/05 00:00:00.000;56;46;10;0.1159414377;0.0128770648
94530;2015/09/05 00:00:00.000;18;12;6;0.0533806619;0.0059287366
94533;2015/09/05 00:00:00.000;78;71;7;0.1411017497;0.0156715012
94534;2015/09/05 00:00:00.000;59;52;7;0.1360016864;0.0151050614
94536;2015/09/05 00:00:00.000;71;59;12;0.1870023188;0.0207694594
94538;2015/09/05 00:00:00.000;57;49;8;0.117981463;0.0131036407
94539;2015/09/05 00:00:00.000;36;36;0;0.1509618719;0.0167666181
94541;2015/09/05 00:00:00.000;49;38;11;0.0914611341;0.0101581538
94542;2015/09/05 00:00:00.000;22;15;7;0.0493006113;0.0054755847
94545;2015/09/05 00:00:00.000;18;14;4;0.025160312;0.0027944364
94546;2015/09/05 00:00:00.000;124;102;22;0.1254615557;0.0139344191
94547;2015/09/05 00:00:00.000;27;22;5;0.0516806408;0.0057399233
94551;2015/09/05 00:00:00.000;62;55;7;0.1186614714;0.013179166
94552;2015/09/05 00:00:00.000;15;13;2;0.0414805144;0.0046070437
94556;2015/09/05 00:00:00.000;19;17;2;0.0452205607;0.0050224329
94559;2015/09/05 00:00:00.000;27;25;2;0.0904411215;0.0100448658
94560;2015/09/05 00:00:00.000;47;47;0;0.0911211299;0.0101203911
94561;2015/09/05 00:00:00.000;51;45;6;0.0877210877;0.0097427646
94565;2015/09/05 00:00:00.000;208;180;28;0.102341269;0.0113665587
94566;2015/09/05 00:00:00.000;61;52;9;0.1836022767;0.0203918328
94568;2015/09/05 00:00:00.000;75;58;17;0.1723821375;0.0191456653
94569;2015/09/05 00:00:00.000;1;1;0;0.0017000211;0.0001888133
94572;2015/09/05 00:00:00.000;6;8;-2;0.007820097;0.000868541
94577;2015/09/05 00:00:00.000;35;28;7;0.0921411426;0.0102336791
94580;2015/09/05 00:00:00.000;24;22;2;0.0401204975;0.0044559931
94585;2015/09/05 00:00:00.000;32;34;-2;0.0482805987;0.0053622968
94586;2015/09/05 00:00:00.000;1;1;0;0.0040800506;0.0004531518
94590;2015/09/05 00:00:00.000;47;44;3;0.1621820111;0.0180127857
94591;2015/09/05 00:00:00.000;73;72;1;0.155721931;0.0172952953
94595;2015/09/05 00:00:00.000;54;48;6;0.1224015178;0.0135945552
94596;2015/09/05 00:00:00.000;24;17;7;0.0693608601;0.0077035813
94597;2015/09/05 00:00:00.000;28;25;3;0.0894211088;0.0099315778
94598;2015/09/05 00:00:00.000;28;24;4;0.1060813154;0.0117819479
94602;2015/09/05 00:00:00.000;21;21;0;0.1339616611;0.0148784854
94603;2015/09/05 00:00:00.000;19;16;3;0.0316203921;0.0035119268
94606;2015/09/05 00:00:00.000;8;7;1;0.0574607125;0.0063818884
94607;2015/09/05 00:00:00.000;18;19;-1;0.0833010329;0.0092518501
94610;2015/09/05 00:00:00.000;21;26;-5;0.1339616611;0.0148784854
94611;2015/09/05 00:00:00.000;138;128;10;0.2315428711;0.025716367
94618;2015/09/05 00:00:00.000;9;12;-3;0.1020012648;0.011328796
94619;2015/09/05 00:00:00.000;25;29;-4;0.0979212142;0.0108756442
94621;2015/09/05 00:00:00.000;18;16;2;0.0544006746;0.0060420245
94702;2015/09/05 00:00:00.000;13;12;1;0.0717408896;0.0079679199
94703;2015/09/05 00:00:00.000;8;9;-1;0.0632407842;0.0070238535
94704;2015/09/05 00:00:00.000;2;2;0;0.03468043;0.0038517906
94705;2015/09/05 00:00:00.000;5;4;1;0.0595007378;0.0066084643
94707;2015/09/05 00:00:00.000;15;18;-3;0.0795609866;0.0088364609
94708;2015/09/05 00:00:00.000;26;28;-2;0.0867010751;0.0096294766
94710;2015/09/05 00:00:00.000;3;3;0;0.0210802614;0.0023412845
94803;2015/09/05 00:00:00.000;124;100;24;0.0734409107;0.0081567331
94806;2015/09/05 00:00:00.000;150;140;10;0.0809210034;0.0089875115
94901;2015/09/05 00:00:00.000;31;28;3;0.1672820743;0.0185792255
94903;2015/09/05 00:00:00.000;33;33;0;0.1142414166;0.0126882515
94920;2015/09/05 00:00:00.000;98;104;-6;0.155721931;0.0172952953
94923;2015/09/05 00:00:00.000;10;8;2;0.0574607125;0.0063818884
94925;2015/09/05 00:00:00.000;4;3;1;0.0411405101;0.0045692811
94928;2015/09/05 00:00:00.000;40;36;4;0.0941811678;0.010460255
94931;2015/09/05 00:00:00.000;7;12;-5;0.0248203078;0.0027566737
94939;2015/09/05 00:00:00.000;3;2;1;0.0353604385;0.003927316
94941;2015/09/05 00:00:00.000;28;31;-3;0.143141775;0.0158980771
94947;2015/09/05 00:00:00.000;30;26;4;0.1162814419;0.0129148275
94951;2015/09/05 00:00:00.000;4;2;2;0.012580156;0.0013972182
94952;2015/09/05 00:00:00.000;32;33;-1;0.1764621881;0.0195988171
94954;2015/09/05 00:00:00.000;34;34;0;0.1094813576;0.0121595744
94960;2015/09/05 00:00:00.000;7;10;-3;0.0448805565;0.0049846703
94965;2015/09/05 00:00:00.000;30;22;8;0.1224015178;0.0135945552
94973;2015/09/05 00:00:00.000;7;4;3;0.0129201602;0.0014349808
95002;2015/09/05 00:00:00.000;4;4;0;0.0054400675;0.0006042025
95004;2015/09/05 00:00:00.000;3;3;0;0.0088401096;0.000981829
95005;2015/09/05 00:00:00.000;6;5;1;0.0486206029;0.0054000594
95006;2015/09/05 00:00:00.000;20;16;4;0.0693608601;0.0077035813
95010;2015/09/05 00:00:00.000;8;12;-4;0.0275403415;0.0030587749
95012;2015/09/05 00:00:00.000;4;2;2;0.0054400675;0.0006042025
95014;2015/09/05 00:00:00.000;29;31;-2;0.1326016443;0.0147274348
95018;2015/09/05 00:00:00.000;11;9;2;0.0557606914;0.0061930752
95020;2015/09/05 00:00:00.000;55;65;-10;0.1441617876;0.016011365
95032;2015/09/05 00:00:00.000;32;34;-2;0.1176414588;0.0130658781
95033;2015/09/05 00:00:00.000;2;4;-2;0.1071013281;0.0118952358
95035;2015/09/05 00:00:00.000;48;41;7;0.1608219942;0.0178617351
95037;2015/09/05 00:00:00.000;56;61;-5;0.190402361;0.0211470859
95039;2015/09/05 00:00:00.000;1;1;0;0.0027200337;0.0003021012
95045;2015/09/05 00:00:00.000;2;2;0;0.0122401518;0.0013594555
95046;2015/09/05 00:00:00.000;3;3;0;0.0146201813;0.0016237941
95051;2015/09/05 00:00:00.000;44;43;1;0.1370216991;0.0152183493
95054;2015/09/05 00:00:00.000;14;12;2;0.0584807252;0.0064951764
95060;2015/09/05 00:00:00.000;45;43;2;0.1938024031;0.0215247124
95066;2015/09/05 00:00:00.000;20;24;-4;0.0554206872;0.0061553125
95070;2015/09/05 00:00:00.000;30;33;-3;0.1176414588;0.0130658781
95073;2015/09/05 00:00:00.000;8;11;-3;0.0367204553;0.0040783666
95076;2015/09/05 00:00:00.000;70;64;6;0.1183214672;0.0131414034
95111;2015/09/05 00:00:00.000;45;42;3;0.1380417117;0.0153316373
95112;2015/09/05 00:00:00.000;25;29;-4;0.1230815262;0.0136700805
95113;2015/09/05 00:00:00.000;6;3;3;0.0102001265;0.0011328796
95116;2015/09/05 00:00:00.000;24;23;1;0.0904411215;0.0100448658
95117;2015/09/05 00:00:00.000;7;9;-2;0.0479405945;0.0053245341
95119;2015/09/05 00:00:00.000;10;9;1;0.0241402993;0.0026811484
95120;2015/09/05 00:00:00.000;28;33;-5;0.1084613449;0.0120462864
95122;2015/09/05 00:00:00.000;28;25;3;0.0567807041;0.0063063631
95123;2015/09/05 00:00:00.000;42;44;-2;0.130561619;0.0145008589
95126;2015/09/05 00:00:00.000;28;28;0;0.1224015178;0.0135945552
95127;2015/09/05 00:00:00.000;52;49;3;0.1380417117;0.0153316373
95130;2015/09/05 00:00:00.000;8;8;0;0.0156401939;0.0017370821
95131;2015/09/05 00:00:00.000;14;17;-3;0.0890811046;0.0098938152
95133;2015/09/05 00:00:00.000;12;10;2;0.045560565;0.0050601956
95134;2015/09/05 00:00:00.000;8;9;-1;0.045560565;0.0050601956
95135;2015/09/05 00:00:00.000;23;28;-5;0.0669808306;0.0074392427
95136;2015/09/05 00:00:00.000;35;34;1;0.1105013702;0.0122728624
95138;2015/09/05 00:00:00.000;30;28;2;0.0938411636;0.0104224923
95139;2015/09/05 00:00:00.000;6;6;0;0.0142801771;0.0015860314
95148;2015/09/05 00:00:00.000;30;31;-1;0.092821151;0.0103092044
95202;2015/09/05 00:00:00.000;1;1;0;0.007820097;0.000868541
95203;2015/09/05 00:00:00.000;17;19;-2;0.0207402572;0.0023035219
95204;2015/09/05 00:00:00.000;28;20;8;0.045560565;0.0050601956
95206;2015/09/05 00:00:00.000;37;26;11;0.0795609866;0.0088364609
95207;2015/09/05 00:00:00.000;44;40;4;0.0615407631;0.0068350403
95212;2015/09/05 00:00:00.000;32;26;6;0.0469205818;0.0052112462
95219;2015/09/05 00:00:00.000;57;56;1;0.0642607968;0.0071371415
95220;2015/09/05 00:00:00.000;1;1;0;0.0068000843;0.0007552531
95222;2015/09/05 00:00:00.000;15;18;-3;0.0180202235;0.0020014206
95228;2015/09/05 00:00:00.000;27;33;-6;0.0238002951;0.0026433857
95236;2015/09/05 00:00:00.000;4;4;0;0.0040800506;0.0004531518
95237;2015/09/05 00:00:00.000;4;4;0;0.0027200337;0.0003021012
95240;2015/09/05 00:00:00.000;37;34;3;0.0571207083;0.0063441258
95242;2015/09/05 00:00:00.000;37;35;2;0.0387604806;0.0043049425
95245;2015/09/05 00:00:00.000;3;1;2;0.0190402361;0.0021147086
95249;2015/09/05 00:00:00.000;7;7;0;0.0044200548;0.0004909145
95258;2015/09/05 00:00:00.000;13;10;3;0.0037400464;0.0004153892
95301;2015/09/05 00:00:00.000;43;46;-3;0.0316203921;0.0035119268
95304;2015/09/05 00:00:00.000;19;19;0;0.0350204343;0.0038895533
95306;2015/09/05 00:00:00.000;4;6;-2;0.0034000422;0.0003776265
95315;2015/09/05 00:00:00.000;5;6;-1;0.0044200548;0.0004909145
95316;2015/09/05 00:00:00.000;8;6;2;0.0023800295;0.0002643386
95320;2015/09/05 00:00:00.000;7;6;1;0.017340215;0.0019258953
95321;2015/09/05 00:00:00.000;21;20;1;0.0289003584;0.0032098255
95326;2015/09/05 00:00:00.000;16;19;-3;0.0105401307;0.0011706423
95329;2015/09/05 00:00:00.000;13;13;0;0.0119001476;0.0013216929
95330;2015/09/05 00:00:00.000;22;14;8;0.0404605017;0.0044937558
95336;2015/09/05 00:00:00.000;37;39;-2;0.0635807884;0.0070616162
95337;2015/09/05 00:00:00.000;32;29;3;0.055080683;0.0061175499
95341;2015/09/05 00:00:00.000;26;25;1;0.0210802614;0.0023412845
95350;2015/09/05 00:00:00.000;64;62;2;0.0958811889;0.0106490683
95351;2015/09/05 00:00:00.000;32;33;-1;0.0493006113;0.0054755847
95354;2015/09/05 00:00:00.000;38;36;2;0.0642607968;0.0071371415
95358;2015/09/05 00:00:00.000;17;17;0;0.0340004216;0.0037762653
95360;2015/09/05 00:00:00.000;16;12;4;0.0091801138;0.0010195916
95365;2015/09/05 00:00:00.000;3;4;-1;0.0006800084;0.0000755253
95368;2015/09/05 00:00:00.000;11;14;-3;0.0139401729;0.0015482688
95372;2015/09/05 00:00:00.000;2;3;-1;0.0023800295;0.0002643386
95376;2015/09/05 00:00:00.000;67;65;2;0.1159414377;0.0128770648
95377;2015/09/05 00:00:00.000;55;46;9;0.0941811678;0.010460255
95380;2015/09/05 00:00:00.000;31;31;0;0.0421605228;0.004682569
95388;2015/09/05 00:00:00.000;8;11;-3;0.0054400675;0.0006042025
95389;2015/09/05 00:00:00.000;2;2;0;0.0183602277;0.0020391833
95401;2015/09/05 00:00:00.000;25;23;2;0.0890811046;0.0098938152
95404;2015/09/05 00:00:00.000;45;43;2;0.187342323;0.020807222
95405;2015/09/05 00:00:00.000;32;34;-2;0.072420898;0.0080434452
95407;2015/09/05 00:00:00.000;21;23;-2;0.0584807252;0.0064951764
95410;2015/09/05 00:00:00.000;1;2;-1;0.0119001476;0.0013216929
95421;2015/09/05 00:00:00.000;3;3;0;0.0248203078;0.0027566737
95422;2015/09/05 00:00:00.000;51;54;-3;0.0510006324;0.005664398
95425;2015/09/05 00:00:00.000;14;18;-4;0.0387604806;0.0043049425
95426;2015/09/05 00:00:00.000;5;2;3;0.0119001476;0.0013216929
95436;2015/09/05 00:00:00.000;2;2;0;0.009520118;0.0010573543
95437;2015/09/05 00:00:00.000;25;21;4;0.0809210034;0.0089875115
95443;2015/09/05 00:00:00.000;3;2;1;0.0020400253;0.0002265759
95448;2015/09/05 00:00:00.000;32;21;11;0.1026812732;0.0114043213
95449;2015/09/05 00:00:00.000;1;2;-1;0.0040800506;0.0004531518
95453;2015/09/05 00:00:00.000;36;45;-9;0.072420898;0.0080434452
95454;2015/09/05 00:00:00.000;2;2;0;0.0057800717;0.0006419651
95458;2015/09/05 00:00:00.000;15;20;-5;0.009520118;0.0010573543
95459;2015/09/05 00:00:00.000;4;4;0;0.0081601012;0.0009063037
95461;2015/09/05 00:00:00.000;7;9;-2;0.0091801138;0.0010195916
95462;2015/09/05 00:00:00.000;4;5;-1;0.0238002951;0.0026433857
95467;2015/09/05 00:00:00.000;25;32;-7;0.0520206451;0.005777686
95470;2015/09/05 00:00:00.000;9;9;0;0.022100274;0.0024545725
95476;2015/09/05 00:00:00.000;45;42;3;0.1846222893;0.0205051208
95482;2015/09/05 00:00:00.000;32;31;1;0.0737809149;0.0081944958
95485;2015/09/05 00:00:00.000;4;4;0;0.0102001265;0.0011328796
95490;2015/09/05 00:00:00.000;12;10;2;0.0244803036;0.002718911
95492;2015/09/05 00:00:00.000;46;45;1;0.0867010751;0.0096294766
95497;2015/09/05 00:00:00.000;12;10;2;0.0782009697;0.0086854103
95501;2015/09/05 00:00:00.000;18;21;-3;0.0431805354;0.004795857
95519;2015/09/05 00:00:00.000;16;20;-4;0.0136001686;0.0015105061
95525;2015/09/05 00:00:00.000;1;2;-1;0.0051000632;0.0005664398
95527;2015/09/05 00:00:00.000;1;1;0;0.0003400042;0.0000377627
95531;2015/09/05 00:00:00.000;92;42;50;0.0969012016;0.0107623562
95542;2015/09/05 00:00:00.000;2;2;0;0.0020400253;0.0002265759
95543;2015/09/05 00:00:00.000;9;5;4;0.0027200337;0.0003021012
95547;2015/09/05 00:00:00.000;1;1;0;0.0006800084;0.0000755253
95548;2015/09/05 00:00:00.000;3;1;2;0.0061200759;0.0006797278
95562;2015/09/05 00:00:00.000;5;4;1;0.0027200337;0.0003021012
95567;2015/09/05 00:00:00.000;10;6;4;0.0098601223;0.0010951169
95570;2015/09/05 00:00:00.000;2;3;-1;0.0153001897;0.0016993194
95573;2015/09/05 00:00:00.000;3;3;0;0.0037400464;0.0004153892
95589;2015/09/05 00:00:00.000;1;1;0;0.0217602698;0.0024168098
95602;2015/09/05 00:00:00.000;52;46;6;0.0979212142;0.0108756442
95603;2015/09/05 00:00:00.000;74;67;7;0.1190014756;0.0132169287
95605;2015/09/05 00:00:00.000;6;6;0;0.029920371;0.0033231135
95610;2015/09/05 00:00:00.000;51;40;11;0.0489606071;0.0054378221
95614;2015/09/05 00:00:00.000;25;23;2;0.012580156;0.0013972182
95616;2015/09/05 00:00:00.000;21;20;1;0.0537206661;0.0059664992
95618;2015/09/05 00:00:00.000;68;64;4;0.0822810203;0.0091385621
95619;2015/09/05 00:00:00.000;9;9;0;0.0139401729;0.0015482688
95623;2015/09/05 00:00:00.000;2;3;-1;0.0068000843;0.0007552531
95626;2015/09/05 00:00:00.000;3;4;-1;0.0030600379;0.0003398639
95629;2015/09/05 00:00:00.000;3;3;0;0.0044200548;0.0004909145
95630;2015/09/05 00:00:00.000;155;132;23;0.29274363;0.0325136446
95632;2015/09/05 00:00:00.000;31;28;3;0.0306003794;0.0033986388
95633;2015/09/05 00:00:00.000;4;3;1;0.0040800506;0.0004531518
95636;2015/09/05 00:00:00.000;9;10;-1;0.0068000843;0.0007552531
95640;2015/09/05 00:00:00.000;14;13;1;0.0163202024;0.0018126074
95641;2015/09/05 00:00:00.000;4;4;0;0.0091801138;0.0010195916
95642;2015/09/05 00:00:00.000;19;14;5;0.0139401729;0.0015482688
95648;2015/09/05 00:00:00.000;162;142;20;0.1298816105;0.0144253336
95658;2015/09/05 00:00:00.000;20;20;0;0.0190402361;0.0021147086
95660;2015/09/05 00:00:00.000;46;44;2;0.0217602698;0.0024168098
95661;2015/09/05 00:00:00.000;54;52;2;0.0979212142;0.0108756442
95662;2015/09/05 00:00:00.000;58;52;6;0.0703808727;0.0078168693
95665;2015/09/05 00:00:00.000;10;13;-3;0.0176802192;0.001963658
95669;2015/09/05 00:00:00.000;4;3;1;0.0037400464;0.0004153892
95672;2015/09/05 00:00:00.000;11;7;4;0.0081601012;0.0009063037
95677;2015/09/05 00:00:00.000;50;45;5;0.0591607336;0.0065707017
95678;2015/09/05 00:00:00.000;87;80;7;0.1319216358;0.0146519095
95681;2015/09/05 00:00:00.000;2;2;0;0.0003400042;0.0000377627
95684;2015/09/05 00:00:00.000;6;5;1;0.0159801982;0.0017748447
95685;2015/09/05 00:00:00.000;8;8;0;0.017340215;0.0019258953
95687;2015/09/05 00:00:00.000;98;93;5;0.1900623568;0.0211093233
95688;2015/09/05 00:00:00.000;51;47;4;0.1462018129;0.016237941
95691;2015/09/05 00:00:00.000;47;46;1;0.0955411847;0.0106113056
95701;2015/09/05 00:00:00.000;4;4;0;0.0037400464;0.0004153892
95703;2015/09/05 00:00:00.000;2;2;0;0.0030600379;0.0003398639
95713;2015/09/05 00:00:00.000;27;22;5;0.0248203078;0.0027566737
95715;2015/09/05 00:00:00.000;1;1;0;0.0034000422;0.0003776265
95722;2015/09/05 00:00:00.000;20;19;1;0.0210802614;0.0023412845
95724;2015/09/05 00:00:00.000;2;2;0;0.0142801771;0.0015860314
95735;2015/09/05 00:00:00.000;1;1;0;0.0057800717;0.0006419651
95742;2015/09/05 00:00:00.000;20;15;5;0.029920371;0.0033231135
95757;2015/09/05 00:00:00.000;81;82;-1;0.1411017497;0.0156715012
95758;2015/09/05 00:00:00.000;76;75;1;0.1482418382;0.0164645169
95762;2015/09/05 00:00:00.000;174;179;-5;0.3185839504;0.0353836063
95776;2015/09/05 00:00:00.000;22;18;4;0.029920371;0.0033231135
95811;2015/09/05 00:00:00.000;10;12;-2;0.0207402572;0.0023035219
95815;2015/09/05 00:00:00.000;26;26;0;0.0557606914;0.0061930752
95816;2015/09/05 00:00:00.000;20;17;3;0.0894211088;0.0099315778
95819;2015/09/05 00:00:00.000;31;27;4;0.102341269;0.0113665587
95820;2015/09/05 00:00:00.000;39;37;2;0.0710608812;0.0078923946
95823;2015/09/05 00:00:00.000;46;48;-2;0.1132214039;0.0125749636
95824;2015/09/05 00:00:00.000;15;13;2;0.0180202235;0.0020014206
95826;2015/09/05 00:00:00.000;50;46;4;0.0969012016;0.0107623562
95827;2015/09/05 00:00:00.000;24;21;3;0.0197202445;0.0021902339
95830;2015/09/05 00:00:00.000;1;1;0;0.0044200548;0.0004909145
95831;2015/09/05 00:00:00.000;39;40;-1;0.100641248;0.0111777454
95834;2015/09/05 00:00:00.000;26;25;1;0.0418205186;0.0046448064
95835;2015/09/05 00:00:00.000;76;70;6;0.1462018129;0.016237941
95838;2015/09/05 00:00:00.000;43;39;4;0.0843210456;0.009365138
95843;2015/09/05 00:00:00.000;56;52;4;0.0741209191;0.0082322584
95864;2015/09/05 00:00:00.000;69;71;-2;0.1332816527;0.0148029601
95912;2015/09/05 00:00:00.000;5;4;1;0.0040800506;0.0004531518
95914;2015/09/05 00:00:00.000;1;1;0;0.0030600379;0.0003398639
95918;2015/09/05 00:00:00.000;2;2;0;0.0027200337;0.0003021012
95919;2015/09/05 00:00:00.000;2;2;0;0.0034000422;0.0003776265
95926;2015/09/05 00:00:00.000;58;62;-4;0.0911211299;0.0101203911
95936;2015/09/05 00:00:00.000;3;3;0;0.0088401096;0.000981829
95941;2015/09/05 00:00:00.000;2;2;0;0.0010200126;0.000113288
95948;2015/09/05 00:00:00.000;17;16;1;0.0200602487;0.0022279966
95949;2015/09/05 00:00:00.000;48;51;-3;0.0785409739;0.0087231729
95953;2015/09/05 00:00:00.000;13;13;0;0.0061200759;0.0006797278
95954;2015/09/05 00:00:00.000;71;83;-12;0.0554206872;0.0061553125
95959;2015/09/05 00:00:00.000;45;42;3;0.105401307;0.0117064226
95960;2015/09/05 00:00:00.000;1;2;-1;0.0020400253;0.0002265759
95962;2015/09/05 00:00:00.000;3;3;0;0.0081601012;0.0009063037
95963;2015/09/05 00:00:00.000;14;13;1;0.0153001897;0.0016993194
95968;2015/09/05 00:00:00.000;1;1;0;0.0003400042;0.0000377627
95971;2015/09/05 00:00:00.000;14;12;2;0.0241402993;0.0026811484
95975;2015/09/05 00:00:00.000;1;1;0;0.0017000211;0.0001888133
95979;2015/09/05 00:00:00.000;4;4;0;0.0013600169;0.0001510506
95983;2015/09/05 00:00:00.000;2;1;1;0.0030600379;0.0003398639
95987;2015/09/05 00:00:00.000;1;1;0;0.0040800506;0.0004531518
95993;2015/09/05 00:00:00.000;38;41;-3;0.0673208348;0.0074770054
96006;2015/09/05 00:00:00.000;1;1;0;0.0061200759;0.0006797278
96007;2015/09/05 00:00:00.000;51;48;3;0.0302603752;0.0033608762
96015;2015/09/05 00:00:00.000;1;1;0;0.0006800084;0.0000755253
96016;2015/09/05 00:00:00.000;1;1;0;0.0010200126;0.000113288
96020;2015/09/05 00:00:00.000;32;8;24;0.0176802192;0.001963658
96021;2015/09/05 00:00:00.000;11;14;-3;0.0190402361;0.0021147086
96024;2015/09/05 00:00:00.000;1;1;0;0.0006800084;0.0000755253
96027;2015/09/05 00:00:00.000;1;1;0;0.004760059;0.0005286771
96028;2015/09/05 00:00:00.000;5;5;0;0.0051000632;0.0005664398
96032;2015/09/05 00:00:00.000;1;1;0;0.0051000632;0.0005664398
96033;2015/09/05 00:00:00.000;5;5;0;0.0013600169;0.0001510506
96038;2015/09/05 00:00:00.000;1;1;0;0.0006800084;0.0000755253
96052;2015/09/05 00:00:00.000;10;7;3;0.0034000422;0.0003776265
96055;2015/09/05 00:00:00.000;4;4;0;0.004760059;0.0005286771
96059;2015/09/05 00:00:00.000;2;2;0;0.0006800084;0.0000755253
96064;2015/09/05 00:00:00.000;5;6;-1;0.0146201813;0.0016237941
96076;2015/09/05 00:00:00.000;2;2;0;0.0013600169;0.0001510506
96091;2015/09/05 00:00:00.000;4;4;0;0.0023800295;0.0002643386
96096;2015/09/05 00:00:00.000;1;1;0;0.0044200548;0.0004909145
96103;2015/09/05 00:00:00.000;129;108;21;0.0108801349;0.0012084049
96104;2015/09/05 00:00:00.000;2;1;1;0.0044200548;0.0004909145
96112;2015/09/05 00:00:00.000;1;1;0;0.0006800084;0.0000755253
96122;2015/09/05 00:00:00.000;13;10;3;0.0193802403;0.0021524712
96125;2015/09/05 00:00:00.000;4;2;2;0.0013600169;0.0001510506
96126;2015/09/05 00:00:00.000;1;1;0;0.004760059;0.0005286771
96129;2015/09/05 00:00:00.000;2;1;1;0.0003400042;0.0000377627
96133;2015/09/05 00:00:00.000;4;4;0;0.0006800084;0.0000755253
96137;2015/09/05 00:00:00.000;137;52;85;0.0591607336;0.0065707017
96140;2015/09/05 00:00:00.000;5;6;-1;0.0234602909;0.0026056231
96142;2015/09/05 00:00:00.000;7;6;1;0.0217602698;0.0024168098
96143;2015/09/05 00:00:00.000;15;16;-1;0.0217602698;0.0024168098
96146;2015/09/05 00:00:00.000;60;78;-18;0.0193802403;0.0021524712
96148;2015/09/05 00:00:00.000;14;15;-1;0.0244803036;0.002718911
96161;2015/09/05 00:00:00.000;169;182;-13;0.3444242709;0.0382535679
96701;2015/09/05 00:00:00.000;40;37;3;2.0856068874;0.0064951764
96704;2015/09/05 00:00:00.000;58;58;0;1.6975870013;0.0052867715
96705;2015/09/05 00:00:00.000;2;2;0;0.0242512429;0.0000755253
96706;2015/09/05 00:00:00.000;87;73;14;2.4251242876;0.0075525307
96707;2015/09/05 00:00:00.000;66;73;-7;2.3766218019;0.0074014801
96708;2015/09/05 00:00:00.000;17;18;-1;1.2489390081;0.0038895533
96716;2015/09/05 00:00:00.000;1;1;0;0.0242512429;0.0000755253
96720;2015/09/05 00:00:00.000;46;47;-1;4.8138717109;0.0149917734
96727;2015/09/05 00:00:00.000;3;2;1;0.5214017218;0.0016237941
96728;2015/09/05 00:00:00.000;1;1;0;0.0485024858;0.0001510506
96731;2015/09/05 00:00:00.000;8;6;2;0.2910149145;0.0009063037
96732;2015/09/05 00:00:00.000;18;12;6;0.691160422;0.0021524712
96734;2015/09/05 00:00:00.000;47;53;-6;3.3466715169;0.0104224923
96740;2015/09/05 00:00:00.000;119;125;-6;7.1056141627;0.0221289149
96743;2015/09/05 00:00:00.000;53;44;9;1.8915969443;0.0058909739
96744;2015/09/05 00:00:00.000;54;43;11;3.3587971384;0.010460255
96748;2015/09/05 00:00:00.000;1;4;-3;0.5092761004;0.0015860314
96752;2015/09/05 00:00:00.000;2;2;0;0.0485024858;0.0001510506
96756;2015/09/05 00:00:00.000;34;36;-2;0.6184066933;0.0019258953
96760;2015/09/05 00:00:00.000;5;6;-1;0.2303868073;0.0007174904
96761;2015/09/05 00:00:00.000;85;88;-3;3.431550867;0.0106868309
96762;2015/09/05 00:00:00.000;4;3;1;0.2546380502;0.0007930157
96763;2015/09/05 00:00:00.000;2;2;0;0.0848793501;0.0002643386
96768;2015/09/05 00:00:00.000;8;9;-1;0.7517885292;0.0023412845
96770;2015/09/05 00:00:00.000;1;1;0;0.6305323148;0.001963658
96771;2015/09/05 00:00:00.000;14;11;3;1.0913059294;0.0033986388
96778;2015/09/05 00:00:00.000;55;46;9;2.3887474233;0.0074392427
96779;2015/09/05 00:00:00.000;3;2;1;0.1333818358;0.0004153892
96781;2015/09/05 00:00:00.000;1;1;0;0.0848793501;0.0002643386
96782;2015/09/05 00:00:00.000;17;14;3;1.0549290651;0.0032853508
96783;2015/09/05 00:00:00.000;1;1;0;0.194009943;0.0006042025
96785;2015/09/05 00:00:00.000;16;14;2;1.0185522008;0.0031720629
96786;2015/09/05 00:00:00.000;14;13;1;0.5456529647;0.0016993194
96789;2015/09/05 00:00:00.000;85;79;6;3.5043045956;0.0109134068
96790;2015/09/05 00:00:00.000;15;16;-1;1.2853158724;0.0040028413
96791;2015/09/05 00:00:00.000;15;19;-4;0.4122711289;0.0012839302
96792;2015/09/05 00:00:00.000;49;47;2;1.1883109009;0.00370074
96793;2015/09/05 00:00:00.000;36;28;8;2.3887474233;0.0074392427
96795;2015/09/05 00:00:00.000;8;7;1;0.5699042076;0.0017748447
96796;2015/09/05 00:00:00.000;1;1;0;0.2667636716;0.0008307784
96797;2015/09/05 00:00:00.000;46;42;4;1.2853158724;0.0040028413
96813;2015/09/05 00:00:00.000;57;45;12;2.2553655875;0.0070238535
96814;2015/09/05 00:00:00.000;58;62;-4;1.4308233297;0.0044559931
96815;2015/09/05 00:00:00.000;169;170;-1;5.2382684613;0.0163134663
96816;2015/09/05 00:00:00.000;56;49;7;3.7831938887;0.0117819479
96817;2015/09/05 00:00:00.000;33;36;-3;1.5157026798;0.0047203317
96819;2015/09/05 00:00:00.000;13;13;0;1.0306778222;0.0032098255
96822;2015/09/05 00:00:00.000;57;57;0;3.4800533527;0.0108378815
96825;2015/09/05 00:00:00.000;55;55;0;3.431550867;0.0106868309
97004;2015/09/05 00:00:00.000;5;6;-1;0.0560961928;0.000868541
97005;2015/09/05 00:00:00.000;25;23;2;0.3121875076;0.0048336196
97006;2015/09/05 00:00:00.000;180;170;10;0.958513207;0.0148407228
97007;2015/09/05 00:00:00.000;356;332;24;1.1926538377;0.0184659375
97008;2015/09/05 00:00:00.000;43;29;14;0.3487719812;0.0054000594
97009;2015/09/05 00:00:00.000;14;15;-1;0.175605473;0.002718911
97011;2015/09/05 00:00:00.000;1;1;0;0.0609741226;0.0009440663
97013;2015/09/05 00:00:00.000;41;39;2;0.302431648;0.004682569
97014;2015/09/05 00:00:00.000;4;5;-1;0.0317065437;0.0004909145
97015;2015/09/05 00:00:00.000;37;28;9;0.1951171923;0.0030210123
97016;2015/09/05 00:00:00.000;66;64;2;0.0951196312;0.0014727435
97017;2015/09/05 00:00:00.000;3;3;0;0.0048779298;0.0000755253
97018;2015/09/05 00:00:00.000;5;5;0;0.0317065437;0.0004909145
97020;2015/09/05 00:00:00.000;1;1;0;0.0121948245;0.0001888133
97021;2015/09/05 00:00:00.000;1;1;0;0.0195117192;0.0003021012
97022;2015/09/05 00:00:00.000;9;11;-2;0.0804858418;0.0012461676
97023;2015/09/05 00:00:00.000;26;24;2;0.3438940514;0.0053245341
97026;2015/09/05 00:00:00.000;4;5;-1;0.0170727543;0.0002643386
97027;2015/09/05 00:00:00.000;19;17;2;0.1121923856;0.0017370821
97028;2015/09/05 00:00:00.000;7;10;-3;0.0902417014;0.0013972182
97034;2015/09/05 00:00:00.000;86;79;7;0.958513207;0.0148407228
97037;2015/09/05 00:00:00.000;4;4;0;0.0097558596;0.0001510506
97040;2015/09/05 00:00:00.000;5;4;1;0.1292651399;0.0020014206
97041;2015/09/05 00:00:00.000;9;9;0;0.051218263;0.0007930157
97045;2015/09/05 00:00:00.000;118;99;19;1.0414380137;0.016124653
97048;2015/09/05 00:00:00.000;16;14;2;0.175605473;0.002718911
97051;2015/09/05 00:00:00.000;46;43;3;0.1853613327;0.0028699617
97053;2015/09/05 00:00:00.000;3;3;0;0.0585351577;0.0009063037
97055;2015/09/05 00:00:00.000;54;63;-9;0.429257823;0.006646227
97056;2015/09/05 00:00:00.000;25;33;-8;0.2438964903;0.0037762653
97060;2015/09/05 00:00:00.000;88;64;24;0.2365795956;0.0036629774
97062;2015/09/05 00:00:00.000;50;44;6;0.3195044023;0.0049469076
97064;2015/09/05 00:00:00.000;11;17;-6;0.0268286139;0.0004153892
97065;2015/09/05 00:00:00.000;2;2;0;0.0099005;0.0001453841
97070;2015/09/05 00:00:00.000;88;71;17;0.3609668057;0.0055888727
97071;2015/09/05 00:00:00.000;41;36;5;0.1804834028;0.0027944364
97080;2015/09/05 00:00:00.000;84;93;-9;0.4414526475;0.0068350403
97101;2015/09/05 00:00:00.000;7;11;-4;0.0560961928;0.000868541
97102;2015/09/05 00:00:00.000;10;8;2;0.0390234385;0.0006042025
97103;2015/09/05 00:00:00.000;79;86;-7;1.0487549084;0.016237941
97106;2015/09/05 00:00:00.000;3;3;0;0.1073144557;0.0016615568
97109;2015/09/05 00:00:00.000;1;1;0;0.0048779298;0.0000755253
97110;2015/09/05 00:00:00.000;30;30;0;0.3609668057;0.0055888727
97114;2015/09/05 00:00:00.000;11;14;-3;0.0853637716;0.0013216929
97115;2015/09/05 00:00:00.000;13;10;3;0.1243872101;0.0019258953
97116;2015/09/05 00:00:00.000;31;38;-7;0.3365771567;0.0052112462
97117;2015/09/05 00:00:00.000;2;2;0;0.0170727543;0.0002643386
97121;2015/09/05 00:00:00.000;5;4;1;0.0219506841;0.0003398639
97122;2015/09/05 00:00:00.000;2;2;0;0.0317065437;0.0004909145
97127;2015/09/05 00:00:00.000;12;10;2;0.0317065437;0.0004909145
97128;2015/09/05 00:00:00.000;76;67;9;0.9975366454;0.0154449252
97131;2015/09/05 00:00:00.000;11;14;-3;0.2292627009;0.0035496894
97132;2015/09/05 00:00:00.000;61;57;4;0.3853564547;0.0059664992
97136;2015/09/05 00:00:00.000;38;31;7;0.353649911;0.0054755847
97137;2015/09/05 00:00:00.000;1;1;0;0.0048779298;0.0000755253
97147;2015/09/05 00:00:00.000;1;1;0;0.0268286139;0.0004153892
97148;2015/09/05 00:00:00.000;9;11;-2;0.051218263;0.0007930157
97203;2015/09/05 00:00:00.000;61;58;3;0.4438916124;0.0068728029
97205;2015/09/05 00:00:00.000;13;12;1;0.3292602619;0.0050979582
97206;2015/09/05 00:00:00.000;72;74;-2;1.285334504;0.0199009183
97209;2015/09/05 00:00:00.000;38;29;9;0.9560742421;0.0148029601
97210;2015/09/05 00:00:00.000;22;20;2;0.656081559;0.0101581538
97214;2015/09/05 00:00:00.000;20;16;4;0.5365722787;0.0083077838
97215;2015/09/05 00:00:00.000;19;17;2;0.5170605595;0.0080056825
97218;2015/09/05 00:00:00.000;24;22;2;0.2463354552;0.003814028
97219;2015/09/05 00:00:00.000;96;91;5;1.4950854857;0.0231485065
97222;2015/09/05 00:00:00.000;53;41;12;0.7341284359;0.0113665587
97223;2015/09/05 00:00:00.000;236;244;-8;0.6170581205;0.0095539513
97227;2015/09/05 00:00:00.000;6;4;2;0.0560961928;0.000868541
97232;2015/09/05 00:00:00.000;14;11;3;0.2097509817;0.0032475882
97233;2015/09/05 00:00:00.000;43;41;2;0.5316943489;0.0082322584
97239;2015/09/05 00:00:00.000;28;31;-3;0.4512085071;0.0069860909
97266;2015/09/05 00:00:00.000;44;44;0;0.63169191;0.0097805272
97305;2015/09/05 00:00:00.000;69;50;19;0.3853564547;0.0059664992
97306;2015/09/05 00:00:00.000;106;106;0;0.6585205239;0.0101959164
97321;2015/09/05 00:00:00.000;51;51;0;0.5438891734;0.0084210717
97322;2015/09/05 00:00:00.000;57;45;12;0.5829126119;0.0090252742
97325;2015/09/05 00:00:00.000;23;20;3;0.0390234385;0.0006042025
97330;2015/09/05 00:00:00.000;61;59;2;0.5975464013;0.0092518501
97333;2015/09/05 00:00:00.000;35;30;5;0.2999926831;0.0046448064
97341;2015/09/05 00:00:00.000;36;42;-6;0.4048681739;0.0062686005
97344;2015/09/05 00:00:00.000;1;1;0;0.0121948245;0.0001888133
97348;2015/09/05 00:00:00.000;1;2;-1;0.0097558596;0.0001510506
97350;2015/09/05 00:00:00.000;1;1;0;0.0195117192;0.0003021012
97357;2015/09/05 00:00:00.000;2;2;0;0.0024389649;0.0000377627
97358;2015/09/05 00:00:00.000;5;5;0;0.0414624034;0.0006419651
97361;2015/09/05 00:00:00.000;29;32;-3;0.1609716836;0.0024923351
97362;2015/09/05 00:00:00.000;7;5;2;0.0268286139;0.0004153892
97367;2015/09/05 00:00:00.000;100;101;-1;1.1804590132;0.0182771243
97368;2015/09/05 00:00:00.000;17;18;-1;0.1487768591;0.0023035219
97370;2015/09/05 00:00:00.000;27;22;5;0.0853637716;0.0013216929
97371;2015/09/05 00:00:00.000;1;2;-1;0.0073168947;0.000113288
97374;2015/09/05 00:00:00.000;8;7;1;0.1463378942;0.0022657592
97377;2015/09/05 00:00:00.000;2;2;0;0.0073168947;0.000113288
97378;2015/09/05 00:00:00.000;25;24;1;0.0951196312;0.0014727435
97383;2015/09/05 00:00:00.000;27;22;5;0.202434087;0.0031343002
97389;2015/09/05 00:00:00.000;1;1;0;0.0048779298;0.0000755253
97390;2015/09/05 00:00:00.000;2;3;-1;0.0170727543;0.0002643386
97394;2015/09/05 00:00:00.000;39;46;-7;0.5170605595;0.0080056825
97396;2015/09/05 00:00:00.000;9;11;-2;0.0560961928;0.000868541
97403;2015/09/05 00:00:00.000;19;19;0;0.1585327187;0.0024545725
97404;2015/09/05 00:00:00.000;86;80;6;0.707299822;0.0109511695
97408;2015/09/05 00:00:00.000;46;51;-5;0.3707226653;0.0057399233
97410;2015/09/05 00:00:00.000;2;2;0;0.0170727543;0.0002643386
97413;2015/09/05 00:00:00.000;74;76;-2;0.1121923856;0.0017370821
97414;2015/09/05 00:00:00.000;2;2;0;0.0068843656;0.000122163
97417;2015/09/05 00:00:00.000;11;11;0;0.0902417014;0.0013972182
97419;2015/09/05 00:00:00.000;3;4;-1;0.0292675788;0.0004531518
97426;2015/09/05 00:00:00.000;28;29;-1;0.1365820346;0.0021147086
97430;2015/09/05 00:00:00.000;2;2;0;0.0097558596;0.0001510506
97431;2015/09/05 00:00:00.000;4;4;0;0.0219506841;0.0003398639
97434;2015/09/05 00:00:00.000;3;3;0;0.0121948245;0.0001888133
97435;2015/09/05 00:00:00.000;10;6;4;0.0341455086;0.0005286771
97437;2015/09/05 00:00:00.000;4;5;-1;0.0317065437;0.0004909145
97438;2015/09/05 00:00:00.000;2;2;0;0.0195117192;0.0003021012
97442;2015/09/05 00:00:00.000;2;3;-1;0.0463403332;0.0007174904
97443;2015/09/05 00:00:00.000;3;3;0;0.0219506841;0.0003398639
97446;2015/09/05 00:00:00.000;10;9;1;0.051218263;0.0007930157
97447;2015/09/05 00:00:00.000;1;1;0;0.00495025;0.000072692
97450;2015/09/05 00:00:00.000;3;4;-1;0.0219506841;0.0003398639
97451;2015/09/05 00:00:00.000;2;1;1;0.0219506841;0.0003398639
97454;2015/09/05 00:00:00.000;4;4;0;0.0195117192;0.0003021012
97455;2015/09/05 00:00:00.000;5;6;-1;0.0804858418;0.0012461676
97459;2015/09/05 00:00:00.000;38;36;2;0.3097485427;0.004795857
97463;2015/09/05 00:00:00.000;7;10;-3;0.0780468769;0.0012084049
97467;2015/09/05 00:00:00.000;78;74;4;0.1926782274;0.0029832496
97473;2015/09/05 00:00:00.000;4;2;2;0.0317065437;0.0004909145
97479;2015/09/05 00:00:00.000;27;24;3;0.1926782274;0.0029832496
97480;2015/09/05 00:00:00.000;1;1;0;0.024389649;0.0003776265
97489;2015/09/05 00:00:00.000;9;10;-1;0.051218263;0.0007930157
97490;2015/09/05 00:00:00.000;2;2;0;0.0048779298;0.0000755253
97493;2015/09/05 00:00:00.000;2;2;0;0.0121948245;0.0001888133
97497;2015/09/05 00:00:00.000;6;6;0;0.0097558596;0.0001510506
97498;2015/09/05 00:00:00.000;20;26;-6;0.3219433672;0.0049846703
97501;2015/09/05 00:00:00.000;120;136;-16;1.0877783469;0.0168421434
97502;2015/09/05 00:00:00.000;93;105;-12;0.529255384;0.0081944958
97520;2015/09/05 00:00:00.000;118;133;-15;1.160947294;0.017975023
97522;2015/09/05 00:00:00.000;1;1;0;0.0317065437;0.0004909145
97525;2015/09/05 00:00:00.000;21;23;-2;0.1195092803;0.00185037
97526;2015/09/05 00:00:00.000;115;123;-8;1.3926489598;0.0215624751
97530;2015/09/05 00:00:00.000;42;49;-7;0.5902295066;0.0091385621
97531;2015/09/05 00:00:00.000;4;5;-1;0.0048779298;0.0000755253
97535;2015/09/05 00:00:00.000;11;11;0;0.1658496134;0.0025678604
97536;2015/09/05 00:00:00.000;7;9;-2;0.0609741226;0.0009440663
97539;2015/09/05 00:00:00.000;27;31;-4;0.1292651399;0.0020014206
97540;2015/09/05 00:00:00.000;25;23;2;0.1853613327;0.0028699617
97544;2015/09/05 00:00:00.000;9;7;2;0.0658520524;0.0010195916
97601;2015/09/05 00:00:00.000;81;82;-1;0.7243725763;0.0112155081
97624;2015/09/05 00:00:00.000;19;18;1;0.2414575254;0.0037385027
97632;2015/09/05 00:00:00.000;2;2;0;0.0121948245;0.0001888133
97633;2015/09/05 00:00:00.000;1;1;0;0.0121948245;0.0001888133
97636;2015/09/05 00:00:00.000;2;1;1;0.0073168947;0.000113288
97640;2015/09/05 00:00:00.000;1;1;0;0.0048779298;0.0000755253
97707;2015/09/05 00:00:00.000;282;312;-30;1.4438672228;0.0223554908
97720;2015/09/05 00:00:00.000;12;9;3;0.024389649;0.0003776265
97733;2015/09/05 00:00:00.000;60;52;8;0.0951196312;0.0014727435
97741;2015/09/05 00:00:00.000;58;52;6;0.3438940514;0.0053245341
97750;2015/09/05 00:00:00.000;1;1;0;0.0170727543;0.0002643386
97753;2015/09/05 00:00:00.000;14;21;-7;0.099997561;0.0015482688
97754;2015/09/05 00:00:00.000;72;84;-12;0.7755908392;0.0120085238
97759;2015/09/05 00:00:00.000;63;65;-2;0.6902270676;0.0106868309
97760;2015/09/05 00:00:00.000;41;47;-6;0.2682861394;0.0041538919
97812;2015/09/05 00:00:00.000;2;2;0;0.0048779298;0.0000755253
97818;2015/09/05 00:00:00.000;2;3;-1;0.0146337894;0.0002265759
97824;2015/09/05 00:00:00.000;4;3;1;0.0097558596;0.0001510506
97828;2015/09/05 00:00:00.000;8;5;3;0.0439013683;0.0006797278
97834;2015/09/05 00:00:00.000;3;6;-3;0.0170727543;0.0002643386
97838;2015/09/05 00:00:00.000;23;28;-5;0.2195068413;0.0033986388
97844;2015/09/05 00:00:00.000;3;3;0;0.0121948245;0.0001888133
97845;2015/09/05 00:00:00.000;3;3;0;0.0487792981;0.0007552531
97846;2015/09/05 00:00:00.000;5;8;-3;0.075607912;0.0011706423
97857;2015/09/05 00:00:00.000;3;2;1;0.0048779298;0.0000755253
97865;2015/09/05 00:00:00.000;2;2;0;0.0146337894;0.0002265759
97870;2015/09/05 00:00:00.000;3;4;-1;0.0170727543;0.0002643386
97876;2015/09/05 00:00:00.000;3;3;0;0.0121948245;0.0001888133
97883;2015/09/05 00:00:00.000;3;2;1;0.0682910173;0.0010573543
97886;2015/09/05 00:00:00.000;4;8;-4;0.024389649;0.0003776265
97907;2015/09/05 00:00:00.000;3;3;0;0.0390234385;0.0006042025
97913;2015/09/05 00:00:00.000;7;8;-1;0.0439013683;0.0006797278
97918;2015/09/05 00:00:00.000;9;10;-1;0.0317065437;0.0004909145
98002;2015/09/05 00:00:00.000;34;38;-4;0.2695291443;0.0043427051
98003;2015/09/05 00:00:00.000;44;50;-6;0.2789040711;0.0044937558
98004;2015/09/05 00:00:00.000;244;258;-14;0.6726509949;0.0108378815
98005;2015/09/05 00:00:00.000;22;24;-2;0.2109358521;0.0033986388
98006;2015/09/05 00:00:00.000;51;54;-3;0.7007757752;0.0112910334
98007;2015/09/05 00:00:00.000;27;27;0;0.2296857056;0.00370074
98008;2015/09/05 00:00:00.000;35;36;-1;0.4148405091;0.0066839897
98010;2015/09/05 00:00:00.000;14;15;-1;0.0351559753;0.0005664398
98012;2015/09/05 00:00:00.000;492;590;-98;0.7218693604;0.0116308973
98014;2015/09/05 00:00:00.000;15;17;-2;0.0773431458;0.0012461676
98019;2015/09/05 00:00:00.000;23;27;-4;0.1265615112;0.0020391833
98020;2015/09/05 00:00:00.000;112;118;-6;0.2062483887;0.0033231135
98021;2015/09/05 00:00:00.000;52;46;6;0.1640612183;0.0026433857
98022;2015/09/05 00:00:00.000;48;60;-12;0.2296857056;0.00370074
98023;2015/09/05 00:00:00.000;85;84;1;0.4664026062;0.007514768
98024;2015/09/05 00:00:00.000;10;10;0;0.0820306091;0.0013216929
98027;2015/09/05 00:00:00.000;49;55;-6;0.3749970703;0.0060420245
98028;2015/09/05 00:00:00.000;90;120;-30;0.203904657;0.0032853508
98029;2015/09/05 00:00:00.000;37;52;-15;0.4593714112;0.0074014801
98030;2015/09/05 00:00:00.000;38;47;-9;0.234373169;0.0037762653
98031;2015/09/05 00:00:00.000;43;51;-8;0.2953101929;0.0047580943
98032;2015/09/05 00:00:00.000;40;50;-10;0.2578104859;0.0041538919
98033;2015/09/05 00:00:00.000;85;94;-9;0.7757751893;0.0124994383
98034;2015/09/05 00:00:00.000;106;116;-10;0.9773361146;0.0157470265
98036;2015/09/05 00:00:00.000;154;148;6;0.2437480957;0.003927316
98037;2015/09/05 00:00:00.000;35;34;1;0.1593737549;0.0025678604
98038;2015/09/05 00:00:00.000;77;89;-12;0.3234349732;0.0052112462
98039;2015/09/05 00:00:00.000;10;10;0;0.1195303162;0.0019258953
98040;2015/09/05 00:00:00.000;34;38;-4;0.4359340943;0.0070238535
98042;2015/09/05 00:00:00.000;256;326;-70;0.3539034851;0.0057021607
98045;2015/09/05 00:00:00.000;28;32;-4;0.2273419739;0.0036629774
98047;2015/09/05 00:00:00.000;8;7;1;0.0117186584;0.0001888133
98051;2015/09/05 00:00:00.000;7;7;0;0.0281247803;0.0004531518
98053;2015/09/05 00:00:00.000;36;40;-4;0.2976539246;0.004795857
98055;2015/09/05 00:00:00.000;28;35;-7;0.16640495;0.0026811484
98056;2015/09/05 00:00:00.000;79;76;3;0.2296857056;0.00370074
98057;2015/09/05 00:00:00.000;10;10;0;0.1007804627;0.0016237941
98058;2015/09/05 00:00:00.000;83;92;-9;0.4406215576;0.0070993788
98059;2015/09/05 00:00:00.000;146;194;-48;0.3070288513;0.0049469076
98065;2015/09/05 00:00:00.000;25;33;-8;0.2695291443;0.0043427051
98068;2015/09/05 00:00:00.000;1;1;0;0.1335927063;0.0021524712
98072;2015/09/05 00:00:00.000;42;47;-5;0.2109358521;0.0033986388
98074;2015/09/05 00:00:00.000;65;76;-11;0.3210912415;0.0051734835
98075;2015/09/05 00:00:00.000;45;47;-2;0.3046851196;0.0049091449
98077;2015/09/05 00:00:00.000;30;37;-7;0.1523425598;0.0024545725
98087;2015/09/05 00:00:00.000;68;66;2;0.3117163147;0.0050224329
98092;2015/09/05 00:00:00.000;113;117;-4;0.3749970703;0.0060420245
98102;2015/09/05 00:00:00.000;22;22;0;0.5999953125;0.0096672393
98103;2015/09/05 00:00:00.000;28;27;1;0.8624932618;0.0138966565
98105;2015/09/05 00:00:00.000;24;21;3;0.5273396302;0.008496597
98106;2015/09/05 00:00:00.000;29;34;-5;0.3749970703;0.0060420245
98108;2015/09/05 00:00:00.000;24;28;-4;0.4593714112;0.0074014801
98109;2015/09/05 00:00:00.000;30;39;-9;0.5367145569;0.0086476476
98112;2015/09/05 00:00:00.000;31;38;-7;0.5859329224;0.0094406634
98115;2015/09/05 00:00:00.000;49;49;0;0.7218693604;0.0116308973
98116;2015/09/05 00:00:00.000;32;33;-1;0.5156209717;0.0083077838
98118;2015/09/05 00:00:00.000;43;53;-10;0.747650409;0.0120462864
98119;2015/09/05 00:00:00.000;23;24;-1;0.4499964844;0.0072504295
98122;2015/09/05 00:00:00.000;35;34;1;0.5578081421;0.0089875115
98133;2015/09/05 00:00:00.000;166;170;-4;0.370309607;0.0059664992
98136;2015/09/05 00:00:00.000;24;31;-7;0.241404364;0.0038895533
98144;2015/09/05 00:00:00.000;41;35;6;0.5531206787;0.0089119862
98168;2015/09/05 00:00:00.000;249;243;6;0.4734338013;0.007628056
98178;2015/09/05 00:00:00.000;60;68;-8;0.4898399231;0.0078923946
98188;2015/09/05 00:00:00.000;168;168;0;0.1546862915;0.0024923351
98198;2015/09/05 00:00:00.000;124;149;-25;0.2531230225;0.0040783666
98201;2015/09/05 00:00:00.000;56;55;1;0.3257787049;0.0052490088
98203;2015/09/05 00:00:00.000;72;70;2;0.3187475098;0.0051357209
98220;2015/09/05 00:00:00.000;2;3;-1;0.0140623901;0.0002265759
98221;2015/09/05 00:00:00.000;103;122;-19;0.8203060914;0.0132169287
98223;2015/09/05 00:00:00.000;107;113;-6;0.302341388;0.0048713823
98226;2015/09/05 00:00:00.000;121;122;-1;0.9304614808;0.0149917734
98229;2015/09/05 00:00:00.000;136;156;-20;1.0288982117;0.0165778048
98230;2015/09/05 00:00:00.000;137;156;-19;0.5554644104;0.0089497489
98233;2015/09/05 00:00:00.000;25;31;-6;0.0749994141;0.0012084049
98239;2015/09/05 00:00:00.000;42;46;-4;0.1828110718;0.002945487
98244;2015/09/05 00:00:00.000;22;32;-10;0.0421871704;0.0006797278
98247;2015/09/05 00:00:00.000;23;27;-4;0.0187498535;0.0003021012
98248;2015/09/05 00:00:00.000;70;81;-11;0.2554667542;0.0041161292
98250;2015/09/05 00:00:00.000;76;81;-5;0.3070288513;0.0049469076
98251;2015/09/05 00:00:00.000;15;12;3;0.0398434387;0.0006419651
98253;2015/09/05 00:00:00.000;16;20;-4;0.0609370239;0.000981829
98257;2015/09/05 00:00:00.000;31;36;-5;0.1218740479;0.001963658
98258;2015/09/05 00:00:00.000;140;148;-8;0.5601518738;0.0090252742
98261;2015/09/05 00:00:00.000;38;36;2;0.1406239014;0.0022657592
98262;2015/09/05 00:00:00.000;7;8;-1;0.0515620972;0.0008307784
98266;2015/09/05 00:00:00.000;22;24;-2;0.105467926;0.0016993194
98267;2015/09/05 00:00:00.000;6;7;-1;0.0328122437;0.0005286771
98272;2015/09/05 00:00:00.000;55;66;-11;0.2765603394;0.0044559931
98273;2015/09/05 00:00:00.000;75;88;-13;0.1921859985;0.0030965376
98275;2015/09/05 00:00:00.000;58;62;-4;0.3374973633;0.0054378221
98276;2015/09/05 00:00:00.000;4;3;1;0.0023437317;0.0000377627
98281;2015/09/05 00:00:00.000;7;4;3;0.067968219;0.0010951169
98283;2015/09/05 00:00:00.000;1;1;0;0.0070311951;0.000113288
98284;2015/09/05 00:00:00.000;54;52;2;0.2695291443;0.0043427051
98288;2015/09/05 00:00:00.000;1;1;0;0.0093749268;0.0001510506
98292;2015/09/05 00:00:00.000;78;78;0;0.2601542175;0.0041916545
98296;2015/09/05 00:00:00.000;53;56;-3;0.203904657;0.0032853508
98310;2015/09/05 00:00:00.000;44;50;-6;0.2015609253;0.0032475882
98311;2015/09/05 00:00:00.000;47;65;-18;0.2203107788;0.0035496894
98323;2015/09/05 00:00:00.000;2;3;-1;0.0117186584;0.0001888133
98327;2015/09/05 00:00:00.000;24;24;0;0.0515620972;0.0008307784
98328;2015/09/05 00:00:00.000;38;50;-12;0.1617174866;0.0026056231
98331;2015/09/05 00:00:00.000;33;33;0;0.1476550964;0.0023790472
98335;2015/09/05 00:00:00.000;104;111;-7;0.4898399231;0.0078923946
98337;2015/09/05 00:00:00.000;9;13;-4;0.0445309021;0.0007174904
98338;2015/09/05 00:00:00.000;74;81;-7;0.2132795838;0.0034364015
98342;2015/09/05 00:00:00.000;5;7;-2;0.0187498535;0.0003021012
98346;2015/09/05 00:00:00.000;46;46;0;0.2507792908;0.0040406039
98358;2015/09/05 00:00:00.000;5;4;1;0.0093749268;0.0001510506
98360;2015/09/05 00:00:00.000;48;54;-6;0.0609370239;0.000981829
98361;2015/09/05 00:00:00.000;31;31;0;0.0726556824;0.0011706423
98365;2015/09/05 00:00:00.000;52;73;-21;0.2460918274;0.0039650786
98366;2015/09/05 00:00:00.000;77;92;-15;0.4359340943;0.0070238535
98370;2015/09/05 00:00:00.000;80;96;-16;0.3867157288;0.0062308378
98371;2015/09/05 00:00:00.000;164;232;-68;0.2624979492;0.0042294172
98374;2015/09/05 00:00:00.000;88;111;-23;0.4593714112;0.0074014801
98375;2015/09/05 00:00:00.000;92;106;-14;0.3281224365;0.0052867715
98376;2015/09/05 00:00:00.000;15;15;0;0.0960929993;0.0015482688
98377;2015/09/05 00:00:00.000;10;13;-3;0.1242177795;0.0020014206
98380;2015/09/05 00:00:00.000;16;19;-3;0.0796868774;0.0012839302
98382;2015/09/05 00:00:00.000;130;161;-31;1.5843626222;0.0255275537
98390;2015/09/05 00:00:00.000;17;19;-2;0.0703119507;0.0011328796
98391;2015/09/05 00:00:00.000;1110;1398;-288;0.4476527527;0.0072126668
98394;2015/09/05 00:00:00.000;1;1;0;0.0023437317;0.0000377627
98405;2015/09/05 00:00:00.000;44;41;3;0.2695291443;0.0043427051
98406;2015/09/05 00:00:00.000;57;56;1;0.3328098999;0.0053622968
98409;2015/09/05 00:00:00.000;34;32;2;0.0867180725;0.0013972182
98418;2015/09/05 00:00:00.000;21;20;1;0.1148428528;0.00185037
98424;2015/09/05 00:00:00.000;15;18;-3;0.030468512;0.0004909145
98443;2015/09/05 00:00:00.000;11;12;-1;0.037499707;0.0006042025
98444;2015/09/05 00:00:00.000;32;33;-1;0.1523425598;0.0024545725
98445;2015/09/05 00:00:00.000;57;65;-8;0.3187475098;0.0051357209
98446;2015/09/05 00:00:00.000;28;33;-5;0.1499988281;0.0024168098
98466;2015/09/05 00:00:00.000;339;351;-12;0.2976539246;0.004795857
98467;2015/09/05 00:00:00.000;148;146;2;0.1945297302;0.0031343002
98498;2015/09/05 00:00:00.000;264;266;-2;0.2976539246;0.004795857
98499;2015/09/05 00:00:00.000;144;172;-28;0.1429676331;0.0023035219
98501;2015/09/05 00:00:00.000;312;344;-32;0.5156209717;0.0083077838
98502;2015/09/05 00:00:00.000;102;98;4;0.4968711182;0.0080056825
98516;2015/09/05 00:00:00.000;270;280;-10;0.2648416809;0.0042671798
98520;2015/09/05 00:00:00.000;76;86;-10;0.2554667542;0.0041161292
98524;2015/09/05 00:00:00.000;15;19;-4;0.0609370239;0.000981829
98531;2015/09/05 00:00:00.000;76;78;-2;0.1640612183;0.0026433857
98532;2015/09/05 00:00:00.000;117;125;-8;0.1289052429;0.0020769459
98535;2015/09/05 00:00:00.000;2;3;-1;0.0093749268;0.0001510506
98546;2015/09/05 00:00:00.000;15;13;2;0.0609370239;0.000981829
98548;2015/09/05 00:00:00.000;58;67;-9;0.1476550964;0.0023790472
98550;2015/09/05 00:00:00.000;34;38;-4;0.0796868774;0.0012839302
98555;2015/09/05 00:00:00.000;4;5;-1;0.0187498535;0.0003021012
98562;2015/09/05 00:00:00.000;5;5;0;0.0234373169;0.0003776265
98563;2015/09/05 00:00:00.000;18;15;3;0.030468512;0.0004909145
98568;2015/09/05 00:00:00.000;9;10;-1;0.0117186584;0.0001888133
98570;2015/09/05 00:00:00.000;7;6;1;0.0210935852;0.0003398639
98571;2015/09/05 00:00:00.000;6;8;-2;0.0328122437;0.0005286771
98575;2015/09/05 00:00:00.000;1;1;0;0.0046874634;0.0000755253
98576;2015/09/05 00:00:00.000;13;12;1;0.0351559753;0.0005664398
98579;2015/09/05 00:00:00.000;32;34;-2;0.1921859985;0.0030965376
98580;2015/09/05 00:00:00.000;36;37;-1;0.1429676331;0.0023035219
98582;2015/09/05 00:00:00.000;3;3;0;0.0023437317;0.0000377627
98586;2015/09/05 00:00:00.000;11;13;-2;0.0281247803;0.0004531518
98587;2015/09/05 00:00:00.000;1;1;0;0.0093749268;0.0001510506
98588;2015/09/05 00:00:00.000;9;12;-3;0.0890618042;0.0014349808
98589;2015/09/05 00:00:00.000;28;25;3;0.0703119507;0.0011328796
98591;2015/09/05 00:00:00.000;8;13;-5;0.0773431458;0.0012461676
98592;2015/09/05 00:00:00.000;8;7;1;0.0656244873;0.0010573543
98595;2015/09/05 00:00:00.000;43;49;-6;0.1312489746;0.0021147086
98596;2015/09/05 00:00:00.000;15;20;-5;0.0703119507;0.0011328796
98601;2015/09/05 00:00:00.000;8;7;1;0.0328122437;0.0005286771
98603;2015/09/05 00:00:00.000;2;2;0;0.0234373169;0.0003776265
98604;2015/09/05 00:00:00.000;86;93;-7;0.4148405091;0.0066839897
98607;2015/09/05 00:00:00.000;106;100;6;0.5015585816;0.0080812078
98613;2015/09/05 00:00:00.000;1;1;0;0.0044335085;0.000072692
98614;2015/09/05 00:00:00.000;1;1;0;0.0140623901;0.0002265759
98619;2015/09/05 00:00:00.000;2;2;0;0.0070311951;0.000113288
98620;2015/09/05 00:00:00.000;19;22;-3;0.1828110718;0.002945487
98624;2015/09/05 00:00:00.000;3;3;0;0.0234373169;0.0003776265
98625;2015/09/05 00:00:00.000;15;17;-2;0.1617174866;0.0026056231
98629;2015/09/05 00:00:00.000;24;17;7;0.067968219;0.0010951169
98631;2015/09/05 00:00:00.000;36;36;0;0.2156233154;0.0034741641
98632;2015/09/05 00:00:00.000;111;133;-22;0.6140577027;0.0098938152
98635;2015/09/05 00:00:00.000;6;9;-3;0.0445309021;0.0007174904
98640;2015/09/05 00:00:00.000;57;54;3;0.2156233154;0.0034741641
98643;2015/09/05 00:00:00.000;3;3;0;0.0070311951;0.000113288
98644;2015/09/05 00:00:00.000;4;3;1;0.0210935852;0.0003398639
98648;2015/09/05 00:00:00.000;17;17;0;0.067968219;0.0010951169
98650;2015/09/05 00:00:00.000;5;7;-2;0.0070311951;0.000113288
98651;2015/09/05 00:00:00.000;4;5;-1;0.0093749268;0.0001510506
98662;2015/09/05 00:00:00.000;74;71;3;0.4804649964;0.007741344
98663;2015/09/05 00:00:00.000;22;28;-6;0.2156233154;0.0034741641
98671;2015/09/05 00:00:00.000;112;113;-1;0.475777533;0.0076658186
98672;2015/09/05 00:00:00.000;14;16;-2;0.1218740479;0.001963658
98674;2015/09/05 00:00:00.000;30;31;-1;0.2484355591;0.0040028413
98675;2015/09/05 00:00:00.000;13;13;0;0.105467926;0.0016993194
98684;2015/09/05 00:00:00.000;41;34;7;0.302341388;0.0048713823
98685;2015/09/05 00:00:00.000;69;77;-8;0.67968219;0.0109511695
98686;2015/09/05 00:00:00.000;47;42;5;0.5249958985;0.0084588344
98801;2015/09/05 00:00:00.000;79;95;-16;0.4968711182;0.0080056825
98802;2015/09/05 00:00:00.000;54;60;-6;0.2765603394;0.0044559931
98812;2015/09/05 00:00:00.000;5;5;0;0.0117186584;0.0001888133
98813;2015/09/05 00:00:00.000;3;3;0;0.0093749268;0.0001510506
98826;2015/09/05 00:00:00.000;40;46;-6;0.1710924133;0.0027566737
98827;2015/09/05 00:00:00.000;2;2;0;0.0023437317;0.0000377627
98828;2015/09/05 00:00:00.000;3;3;0;0.0187498535;0.0003021012
98833;2015/09/05 00:00:00.000;7;6;1;0.0140623901;0.0002265759
98837;2015/09/05 00:00:00.000;103;109;-6;0.3890594605;0.0062686005
98843;2015/09/05 00:00:00.000;11;10;1;0.0328122437;0.0005286771
98844;2015/09/05 00:00:00.000;62;70;-8;0.0843743408;0.0013594555
98847;2015/09/05 00:00:00.000;7;7;0;0.0492183655;0.0007930157
98848;2015/09/05 00:00:00.000;37;51;-14;0.0351559753;0.0005664398
98851;2015/09/05 00:00:00.000;17;20;-3;0.0210935852;0.0003398639
98857;2015/09/05 00:00:00.000;1;1;0;0.0117186584;0.0001888133
98858;2015/09/05 00:00:00.000;1;2;-1;0.0210935852;0.0003398639
98862;2015/09/05 00:00:00.000;26;25;1;0.0539058289;0.000868541
98903;2015/09/05 00:00:00.000;270;244;26;0.1453113648;0.0023412845
98926;2015/09/05 00:00:00.000;87;99;-12;0.2624979492;0.0042294172
98934;2015/09/05 00:00:00.000;2;1;1;0.0022314953;0.000040721
98937;2015/09/05 00:00:00.000;16;12;4;0.0820306091;0.0013216929
98942;2015/09/05 00:00:00.000;33;30;3;0.1453113648;0.0023412845
98947;2015/09/05 00:00:00.000;3;3;0;0.0093749268;0.0001510506
98948;2015/09/05 00:00:00.000;2;3;-1;0.0093749268;0.0001510506
98952;2015/09/05 00:00:00.000;1;1;0;0.0140623901;0.0002265759
98953;2015/09/05 00:00:00.000;9;8;1;0.0257810486;0.0004153892
99004;2015/09/05 00:00:00.000;57;63;-6;0.3234349732;0.0052112462
99005;2015/09/05 00:00:00.000;44;45;-1;0.2484355591;0.0040028413
99009;2015/09/05 00:00:00.000;15;20;-5;0.0703119507;0.0011328796
99016;2015/09/05 00:00:00.000;214;238;-24;0.3304661682;0.0053245341
99019;2015/09/05 00:00:00.000;55;64;-9;0.2578104859;0.0041538919
99025;2015/09/05 00:00:00.000;26;30;-4;0.1499988281;0.0024168098
99026;2015/09/05 00:00:00.000;40;42;-2;0.1968734619;0.0031720629
99029;2015/09/05 00:00:00.000;6;6;0;0.0164061218;0.0002643386
99030;2015/09/05 00:00:00.000;3;4;-1;0.030468512;0.0004909145
99034;2015/09/05 00:00:00.000;3;3;0;0.0046874634;0.0000755253
99036;2015/09/05 00:00:00.000;2;3;-1;0.0140623901;0.0002265759
99101;2015/09/05 00:00:00.000;6;7;-1;0.0164061218;0.0002643386
99111;2015/09/05 00:00:00.000;8;8;0;0.1265615112;0.0020391833
99113;2015/09/05 00:00:00.000;2;2;0;0.0046874634;0.0000755253
99116;2015/09/05 00:00:00.000;2;3;-1;0.0023437317;0.0000377627
99117;2015/09/05 00:00:00.000;1;1;0;0.0117186584;0.0001888133
99122;2015/09/05 00:00:00.000;84;66;18;0.1124991211;0.0018126074
99125;2015/09/05 00:00:00.000;2;2;0;0.0022167542;0.000036346
99126;2015/09/05 00:00:00.000;7;6;1;0.0164061218;0.0002643386
99129;2015/09/05 00:00:00.000;5;5;0;0.0187498535;0.0003021012
99130;2015/09/05 00:00:00.000;4;5;-1;0.0066502627;0.0001090381
99134;2015/09/05 00:00:00.000;5;6;-1;0.0093749268;0.0001510506
99135;2015/09/05 00:00:00.000;2;2;0;0.0046874634;0.0000755253
99138;2015/09/05 00:00:00.000;3;3;0;0.0351559753;0.0005664398
99139;2015/09/05 00:00:00.000;3;4;-1;0.0281247803;0.0004531518
99151;2015/09/05 00:00:00.000;1;1;0;0.0023437317;0.0000377627
99156;2015/09/05 00:00:00.000;32;65;-33;0.1898422669;0.0030587749
99159;2015/09/05 00:00:00.000;1;1;0;0.0140623901;0.0002265759
99170;2015/09/05 00:00:00.000;3;3;0;0.0210935852;0.0003398639
99171;2015/09/05 00:00:00.000;1;1;0;0.0044629907;0.000081442
99176;2015/09/05 00:00:00.000;1;1;0;0.0023437317;0.0000377627
99185;2015/09/05 00:00:00.000;6;6;0;0.0257810486;0.0004153892
99201;2015/09/05 00:00:00.000;35;39;-4;0.4101530457;0.0066084643
99203;2015/09/05 00:00:00.000;113;122;-9;1.0429606019;0.0168043808
99204;2015/09/05 00:00:00.000;18;17;1;0.3445285584;0.0055511101
99208;2015/09/05 00:00:00.000;195;192;3;1.2937398927;0.0208449847
99212;2015/09/05 00:00:00.000;130;138;-8;0.6656197998;0.0107245936
99216;2015/09/05 00:00:00.000;80;86;-6;0.5859329224;0.0094406634
99217;2015/09/05 00:00:00.000;56;64;-8;0.3984343872;0.0064196511
99223;2015/09/05 00:00:00.000;115;129;-14;0.6914008484;0.0111399828
99224;2015/09/05 00:00:00.000;106;106;0;0.6351512879;0.0102336791
99320;2015/09/05 00:00:00.000;12;12;0;0.098436731;0.0015860314
99326;2015/09/05 00:00:00.000;5;3;2;0.0187498535;0.0003021012
99336;2015/09/05 00:00:00.000;91;99;-8;0.3210912415;0.0051734835
99337;2015/09/05 00:00:00.000;63;50;13;0.3257787049;0.0052490088
99344;2015/09/05 00:00:00.000;10;11;-1;0.0421871704;0.0006797278
99347;2015/09/05 00:00:00.000;10;10;0;0.0257810486;0.0004153892
99349;2015/09/05 00:00:00.000;7;14;-7;0.0281247803;0.0004531518
99350;2015/09/05 00:00:00.000;14;15;-1;0.067968219;0.0010951169
99352;2015/09/05 00:00:00.000;82;84;-2;0.5906203858;0.0095161887
99353;2015/09/05 00:00:00.000;29;24;5;0.1921859985;0.0030965376
99354;2015/09/05 00:00:00.000;42;32;10;0.2906227295;0.004682569
99402;2015/09/05 00:00:00.000;5;3;2;0.0044335085;0.000072692
99403;2015/09/05 00:00:00.000;51;46;5;0.1828110718;0.002945487
99501;2015/09/05 00:00:00.000;55;57;-2;2.0061412487;0.00370074
99502;2015/09/05 00:00:00.000;71;69;2;3.3162743091;0.0061175499
99503;2015/09/05 00:00:00.000;15;16;-1;1.0849539406;0.0020014206
99508;2015/09/05 00:00:00.000;60;65;-5;2.5997952917;0.004795857
99515;2015/09/05 00:00:00.000;53;54;-1;2.7430910952;0.0050601956
99516;2015/09/05 00:00:00.000;64;60;4;2.8045035824;0.0051734835
99517;2015/09/05 00:00:00.000;26;30;-4;1.8628454452;0.0034364015
99518;2015/09/05 00:00:00.000;28;31;-3;1.187308086;0.0021902339
99559;2015/09/05 00:00:00.000;4;3;1;0.3684749232;0.0006797278
99568;2015/09/05 00:00:00.000;2;1;1;0.1842374616;0.0003398639
99574;2015/09/05 00:00:00.000;2;2;0;0.0204708291;0.0000377627
99577;2015/09/05 00:00:00.000;80;80;0;3.6847492323;0.0067972776
99611;2015/09/05 00:00:00.000;41;41;0;3.0296827021;0.0055888727
99615;2015/09/05 00:00:00.000;7;9;-2;0.8393039918;0.0015482688
99645;2015/09/05 00:00:00.000;63;60;3;4.3193449335;0.0079679199
99664;2015/09/05 00:00:00.000;5;5;0;1.0440122825;0.0019258953
99676;2015/09/05 00:00:00.000;2;1;1;2.3541453429;0.0043427051
99685;2015/09/05 00:00:00.000;1;1;0;0.0204708291;0.0000377627
99688;2015/09/05 00:00:00.000;6;7;-1;2.2313203685;0.0041161292
99701;2015/09/05 00:00:00.000;46;44;2;1.6581371546;0.0030587749
99712;2015/09/05 00:00:00.000;38;38;0;3.868986694;0.0071371415
99737;2015/09/05 00:00:00.000;5;6;-1;0.3480040942;0.0006419651
99801;2015/09/05 00:00:00.000;50;66;-16;4.2169907881;0.0077791066
99826;2015/09/05 00:00:00.000;1;1;0;0.4503582395;0.0008307784
99827;2015/09/05 00:00:00.000;4;4;0;0.7369498465;0.0013594555
99829;2015/09/05 00:00:00.000;2;3;-1;0.2456499488;0.0004531518
99833;2015/09/05 00:00:00.000;6;6;0;1.2487205732;0.0023035219
