CUSTOMERNUMBER,ORDERDATE,TIME_ID,PRODUCTCODE,QUANTITYORDERED,PRICEEACH,BUYPRICE,TOTALPRICE,TOTALCOST,GROSSPROFIT
1717,1/6/2011,20110106,S24_3969,49,34.47,265,1666,12985,-11319
1717,1/6/2011,20110106,S18_4409,22,86.51,200,1914,4400,-2486
1717,1/6/2011,20110106,S18_2248,50,67.8,50,3400,2500,900
1717,1/6/2011,20110106,S18_1749,30,100,50,3000,1500,1500
22596,1/9/2011,20110109,S24_1937,45,31.2,365,1395,16425,-15030
22596,1/9/2011,20110109,S18_2795,26,100,75,2600,1950,650
22596,1/9/2011,20110109,S18_2325,25,100,60,2500,1500,1000
22596,1/9/2011,20110109,S24_2022,46,53.76,10,2484,460,2024
36046,1/10/2011,20110110,S18_1367,41,50.14,50,2050,2050,0
36046,1/10/2011,20110110,S18_1342,39,100,50,3900,1950,1950
44644,1/29/2011,20110129,S18_4668,41,47.29,215,1927,8815,-6888
44644,1/29/2011,20110129,S24_4258,25,100,365,2500,9125,-6625
44644,1/29/2011,20110129,S18_4600,36,100,200,3600,7200,-3600
44644,1/29/2011,20110129,S18_2957,35,57.46,90,1995,3150,-1155
44644,1/29/2011,20110129,S18_2432,22,54.09,70,1188,1540,-352
44644,1/29/2011,20110129,S18_2949,27,83.07,90,2241,2430,-189
44644,1/29/2011,20110129,S18_3136,25,100,100,2500,2500,0
44644,1/29/2011,20110129,S18_3320,46,100,100,4600,4600,0
44644,1/29/2011,20110129,S18_1097,35,100,50,3500,1750,1750
44644,1/29/2011,20110129,S12_1666,27,100,25,2700,675,2025
44644,1/29/2011,20110129,S10_1949,26,100,10,2600,260,2340
44644,1/29/2011,20110129,S32_1268,31,100,10,3100,310,2790
44644,1/29/2011,20110129,S32_3522,45,75.63,10,3420,450,2970
44644,1/29/2011,20110129,S10_4962,42,100,25,4200,1050,3150
44644,1/29/2011,20110129,S24_2300,36,100,10,3600,360,3240
44644,1/29/2011,20110129,S700_2824,42,100,10,4200,420,3780
94253,1/31/2011,20110131,S24_1444,35,55.49,225,1925,7875,-5950
131955,1/31/2011,20110131,S24_4048,26,100,315,2600,8190,-5590
94253,1/31/2011,20110131,S18_4027,38,100,150,3800,5700,-1900
94253,1/31/2011,20110131,S18_3232,23,100,100,2300,2300,0
94253,1/31/2011,20110131,S18_2319,29,100,60,2900,1740,1160
94253,1/31/2011,20110131,S18_2238,24,100,50,2400,1200,1200
130792,1/31/2011,20110131,S24_2840,44,39.6,10,1760,440,1320
137435,1/31/2011,20110131,S32_2509,35,47.62,10,1680,350,1330
151054,1/31/2011,20110131,S50_1514,32,53.31,10,1696,320,1376
94253,1/31/2011,20110131,S12_3148,34,100,40,3400,1360,2040
94253,1/31/2011,20110131,S12_4473,41,100,40,4100,1640,2460
137435,1/31/2011,20110131,S32_3207,49,65.87,10,3234,490,2744
137435,1/31/2011,20110131,S50_1392,33,100,10,3300,330,2970
176673,2/11/2011,20110211,S24_3816,50,79.67,265,4000,13250,-9250
163496,2/11/2011,20110211,S18_4522,41,82.5,200,3403,8200,-4797
163496,2/11/2011,20110211,S18_3140,22,100,100,2200,2200,0
163496,2/11/2011,20110211,S18_3259,38,100,100,3800,3800,0
198731,2/11/2011,20110211,S72_3212,25,56.78,10,1425,250,1175
188678,2/11/2011,20110211,S700_2610,31,65.77,10,2046,310,1736
163496,2/11/2011,20110211,S12_3891,29,100,40,2900,1160,1740
184419,2/11/2011,20110211,S700_1938,29,70.15,10,2030,290,1740
198076,2/11/2011,20110211,S700_3962,22,100,10,2200,220,1980
183759,2/11/2011,20110211,S700_1138,41,70.67,10,2911,410,2501
196646,2/11/2011,20110211,S700_3505,39,81.14,10,3159,390,2769
171128,2/11/2011,20110211,S24_3151,44,72.58,10,3212,440,2772
155815,2/11/2011,20110211,S12_1108,41,100,25,4100,1025,3075
169882,2/11/2011,20110211,S24_2011,43,100,10,4300,430,3870
153355,2/11/2011,20110211,S10_4757,50,100,20,5000,1000,4000
244692,2/17/2011,20110217,S24_3949,50,64.83,415,3250,20750,-17500
225635,2/17/2011,20110217,S24_1785,28,88.63,315,2492,8820,-6328
205771,2/17/2011,20110217,S18_3856,41,100,150,4100,6150,-2050
205771,2/17/2011,20110217,S18_3029,41,83.44,90,3403,3690,-287
205771,2/17/2011,20110217,S18_2581,34,90.39,75,3060,2550,510
247949,2/17/2011,20110217,S50_1341,39,40.15,10,1560,390,1170
247949,2/17/2011,20110217,S24_4278,26,63.76,15,1664,390,1274
236745,2/17/2011,20110217,S24_3420,31,52.6,10,1643,310,1333
205771,2/17/2011,20110217,S18_1662,36,100,50,3600,1800,1800
320332,2/17/2011,20110217,S72_1253,48,52.64,10,2544,480,2064
247949,2/17/2011,20110217,S32_4289,33,72.92,10,2409,330,2079
317236,2/17/2011,20110217,S700_4002,48,61.44,10,2928,480,2448
247949,2/17/2011,20110217,S700_1691,31,100,10,3100,310,2790
308586,2/17/2011,20110217,S700_3167,44,74.4,10,3256,440,2816
247949,2/17/2011,20110217,S700_2834,32,100,10,3200,320,2880
247949,2/17/2011,20110217,S700_2466,34,100,10,3400,340,3060
235603,2/17/2011,20110217,S24_2841,49,74.68,10,3675,490,3185
348941,2/24/2011,20110224,S24_1578,25,100,240,2500,6000,-3500
348941,2/24/2011,20110224,S18_2625,29,70.87,75,2059,2175,-116
348941,2/24/2011,20110224,S12_2823,21,100,35,2100,735,1365
373896,2/24/2011,20110224,S32_1374,20,92.9,10,1860,200,1660
345858,2/24/2011,20110224,S10_4698,27,100,15,2700,405,2295
321991,2/24/2011,20110224,S10_1678,30,95.7,10,2880,300,2580
348941,2/24/2011,20110224,S24_2000,38,83.03,10,3154,380,2774
327918,2/24/2011,20110224,S10_2016,39,99.91,15,3900,585,3315
426421,3/3/2011,20110303,S24_3856,40,100,365,4000,14600,-10600
391055,3/3/2011,20110303,S18_4721,44,100,215,4400,9460,-5060
391055,3/3/2011,20110303,S18_3782,43,67.77,125,2924,5375,-2451
391055,3/3/2011,20110303,S18_3278,26,68.35,100,1768,2600,-832
391055,3/3/2011,20110303,S18_3482,29,100,115,2900,3335,-435
436345,3/3/2011,20110303,S32_2206,27,43.45,10,1161,270,891
391055,3/3/2011,20110303,S18_1889,38,82.39,50,3116,1900,1216
421982,3/3/2011,20110303,S24_3371,30,63.07,10,1890,300,1590
391055,3/3/2011,20110303,S24_2360,35,58.87,10,2065,350,1715
431566,3/3/2011,20110303,S24_4620,31,68.71,10,2139,310,1829
381710,3/3/2011,20110303,S12_3990,39,89.38,40,3471,1560,1911
382252,3/3/2011,20110303,S12_4675,36,100,45,3600,1620,1980
378139,3/3/2011,20110303,S12_1099,33,100,25,3300,825,2475
437757,3/3/2011,20110303,S50_4713,34,82.99,10,2822,340,2482
380772,3/3/2011,20110303,S12_3380,45,100,40,4500,1800,2700
437757,3/3/2011,20110303,S32_4485,31,100,10,3100,310,2790
458081,3/10/2011,20110310,S18_3685,47,100,115,4700,5405,-705
454169,3/10/2011,20110310,S18_3232,46,100,100,4600,4600,0
475606,3/10/2011,20110310,S24_2972,29,32.1,10,928,290,638
437757,3/10/2011,20110310,S18_2870,26,100,75,2600,1950,650
437757,3/10/2011,20110310,S18_1129,26,100,50,2600,1300,1300
437757,3/10/2011,20110310,S18_1984,38,100,50,3800,1900,1900
534647,3/18/2011,20110318,S24_3969,48,34.47,265,1632,12720,-11088
517164,3/18/2011,20110318,S24_1937,20,35.51,365,720,7300,-6580
507420,3/18/2011,20110318,S18_4933,42,61.29,215,2562,9030,-6468
517164,3/18/2011,20110318,S24_1628,29,59.37,265,1711,7685,-5974
516254,3/18/2011,20110318,S24_1046,36,85.25,215,3060,7740,-4680
490265,3/18/2011,20110318,S18_4409,28,89.27,200,2492,5600,-3108
483898,3/18/2011,20110318,S18_2248,32,50.25,50,1600,1600,0
489689,3/18/2011,20110318,S18_2795,31,100,75,3100,2325,775
486738,3/18/2011,20110318,S18_2325,33,100,60,3300,1980,1320
517164,3/18/2011,20110318,S24_2022,39,44.35,10,1716,390,1326
530995,3/18/2011,20110318,S24_3191,27,73.62,10,1998,270,1728
480861,3/18/2011,20110318,S18_1589,37,100,50,3700,1850,1850
483496,3/18/2011,20110318,S18_1749,42,100,50,4200,2100,2100
517164,3/18/2011,20110318,S24_2766,43,78.15,10,3354,430,2924
532517,3/18/2011,20110318,S24_3432,37,100,10,3700,370,3330
529127,3/18/2011,20110318,S24_2887,46,100,10,4600,460,4140
551672,3/24/2011,20110324,S18_2949,23,100,90,2300,2070,230
549100,3/24/2011,20110324,S10_1949,29,100,10,2900,290,2610
548157,3/25/2011,20110325,S24_4258,26,86.68,365,2262,9490,-7228
540832,3/25/2011,20110325,S18_2957,28,64.33,90,1792,2520,-728
540787,3/25/2011,20110325,S18_1367,48,49.06,50,2352,2400,-48
543009,3/25/2011,20110325,S18_3136,43,100,100,4300,4300,0
543201,3/25/2011,20110325,S18_3320,39,100,100,3900,3900,0
537814,3/25/2011,20110325,S18_1342,33,99.66,50,3300,1650,1650
566908,3/26/2011,20110326,S18_4668,50,49.81,215,2500,10750,-8250
578998,3/26/2011,20110326,S32_3522,23,68.52,10,1587,230,1357
563249,3/26/2011,20110326,S12_1666,21,100,25,2100,525,1575
564993,3/26/2011,20110326,S18_1097,49,100,50,4900,2450,2450
613368,4/1/2011,20110401,S18_4600,41,100,200,4100,8200,-4100
601230,4/1/2011,20110401,S18_2432,45,68.67,70,3105,3150,-45
608219,4/1/2011,20110401,S18_3232,48,100,100,4800,4800,0
616491,4/1/2011,20110401,S24_2840,24,30.06,10,720,240,480
624153,4/1/2011,20110401,S32_2509,28,55.73,10,1568,280,1288
594860,4/1/2011,20110401,S18_2319,39,100,60,3900,2340,1560
614475,4/1/2011,20110401,S24_2300,21,100,10,2100,210,1890
592732,4/1/2011,20110401,S10_4962,31,100,25,3100,775,2325
620576,4/1/2011,20110401,S32_1268,32,100,10,3200,320,2880
626710,4/1/2011,20110401,S700_2824,42,100,10,4200,420,3780
652746,4/4/2011,20110404,S24_4048,44,100,315,4400,13860,-9460
652111,4/4/2011,20110404,S24_1444,47,69.36,225,3243,10575,-7332
651411,4/4/2011,20110404,S18_2238,46,100,50,4600,2300,2300
652865,4/4/2011,20110404,S50_1392,27,100,10,2700,270,2430
636158,4/4/2011,20110404,S12_4473,46,100,40,4600,1840,2760
654337,4/11/2011,20110411,S32_3207,27,63.38,10,1701,270,1431
697671,4/16/2011,20110416,S18_4522,23,97.42,200,2231,4600,-2369
697281,4/16/2011,20110416,S18_4027,22,100,150,2200,3300,-1100
691290,4/16/2011,20110416,S18_3259,21,95.8,100,2016,2100,-84
689530,4/16/2011,20110416,S18_3140,26,100,100,2600,2600,0
706483,4/16/2011,20110416,S50_1514,21,49.21,10,1029,210,819
712931,4/16/2011,20110416,S72_3212,50,43.68,10,2200,500,1700
671965,4/16/2011,20110416,S12_3891,39,100,40,3900,1560,2340
664679,4/16/2011,20110416,S12_1108,33,100,25,3300,825,2475
665357,4/16/2011,20110416,S12_3148,43,100,40,4300,1720,2580
708668,4/16/2011,20110416,S700_1938,38,79.68,10,3040,380,2660
711195,4/16/2011,20110416,S700_3962,45,83.42,10,3735,450,3285
698405,4/16/2011,20110416,S24_2011,41,100,10,4100,410,3690
714399,4/21/2011,20110421,S700_3505,36,100,10,3600,360,3240
778479,4/28/2011,20110428,S24_3949,28,70.29,415,1960,11620,-9660
776797,4/28/2011,20110428,S24_3816,35,90.57,265,3185,9275,-6090
740289,4/28/2011,20110428,S18_3856,27,99.52,150,2700,4050,-1350
740076,4/28/2011,20110428,S18_3029,21,89.46,90,1869,1890,-21
804230,4/28/2011,20110428,S72_1253,28,48.17,10,1344,280,1064
773604,4/28/2011,20110428,S24_3420,20,72.98,10,1460,200,1260
796677,4/28/2011,20110428,S700_4002,26,59.22,10,1534,260,1274
785172,4/28/2011,20110428,S700_1138,25,76.67,10,1925,250,1675
750757,4/28/2011,20110428,S24_2841,41,59.6,10,2460,410,2050
790818,4/28/2011,20110428,S700_2610,38,65.77,10,2508,380,2128
738456,4/28/2011,20110428,S18_1662,43,100,50,4300,2150,2150
773262,4/28/2011,20110428,S24_3151,35,87.62,10,3080,350,2730
730852,4/28/2011,20110428,S10_4757,46,100,20,4600,920,3680
832752,4/29/2011,20110429,S24_1785,39,100,315,3900,12285,-8385
822845,4/29/2011,20110429,S24_1578,35,98.05,240,3430,8400,-4970
815893,4/29/2011,20110429,S18_2625,46,58.15,75,2668,3450,-782
814425,4/29/2011,20110429,S18_2581,29,71.81,75,2088,2175,-87
860805,4/29/2011,20110429,S32_4289,29,72.23,10,2088,290,1798
857829,4/29/2011,20110429,S32_1374,22,100,10,2200,220,1980
863963,4/29/2011,20110429,S50_1341,49,50.62,10,2499,490,2009
857544,4/29/2011,20110429,S24_4278,29,85.49,15,2465,435,2030
880141,4/29/2011,20110429,S700_2466,24,100,10,2400,240,2160
881506,4/29/2011,20110429,S700_2834,24,100,10,2400,240,2160
804444,4/29/2011,20110429,S10_2016,29,96.34,15,2784,435,2349
844025,4/29/2011,20110429,S24_2000,34,83.79,10,2856,340,2516
889391,4/29/2011,20110429,S700_3167,43,76,10,3268,430,2838
865794,4/29/2011,20110429,S700_1691,47,82.21,10,3854,470,3384
806801,4/29/2011,20110429,S10_4698,46,100,15,4600,690,3910
922428,5/7/2011,20110507,S32_4485,25,86.74,10,2175,250,1925
918775,5/7/2011,20110507,S24_2360,32,76.88,10,2464,320,2144
900024,5/7/2011,20110507,S10_1678,34,81.35,10,2754,340,2414
923868,5/7/2011,20110507,S50_4713,44,74.85,10,3300,440,2860
910285,5/7/2011,20110507,S12_2823,50,100,35,5000,1750,3250
994336,5/8/2011,20110508,S24_3856,43,100,365,4300,15695,-11395
989103,5/8/2011,20110508,S18_4721,28,100,215,2800,6020,-3220
987986,5/8/2011,20110508,S18_3782,35,49.74,125,1750,4375,-2625
976031,5/8/2011,20110508,S18_3278,21,73.17,100,1533,2100,-567
976679,5/8/2011,20110508,S18_3482,21,100,115,2100,2415,-315
974546,5/8/2011,20110508,S18_3232,25,100,100,2500,2500,0
932562,5/8/2011,20110508,S12_3990,32,63.84,40,2048,1280,768
989926,5/8/2011,20110508,S24_2972,39,30.96,10,1209,390,819
967274,5/8/2011,20110508,S18_1889,43,72.38,50,3096,2150,946
1003290,5/8/2011,20110508,S32_2206,31,44.66,10,1395,310,1085
934318,5/8/2011,20110508,S12_4675,20,100,45,2000,900,1100
992260,5/8/2011,20110508,S24_3371,34,50.21,10,1700,340,1360
973746,5/8/2011,20110508,S18_1984,31,100,50,3100,1550,1550
955015,5/8/2011,20110508,S18_1129,34,100,50,3400,1700,1700
1000465,5/8/2011,20110508,S24_4620,29,71.14,10,2059,290,1769
929744,5/8/2011,20110508,S12_3380,37,99.82,40,3700,1480,2220
927435,5/8/2011,20110508,S12_1099,42,100,25,4200,1050,3150
1024249,5/20/2011,20110520,S24_1628,50,59.87,265,3000,13250,-10250
1020435,5/20/2011,20110520,S18_3685,34,100,115,3400,3910,-510
1013812,5/20/2011,20110520,S18_2870,46,100,75,4600,3450,1150
1007769,5/20/2011,20110520,S18_1589,26,100,50,2600,1300,1300
1053395,5/21/2011,20110521,S24_1937,45,37.84,365,1710,16425,-14715
1092158,5/21/2011,20110521,S24_3969,46,33.23,265,1518,12190,-10672
1037456,5/21/2011,20110521,S18_4409,36,85.59,200,3096,7200,-4104
1038028,5/21/2011,20110521,S18_4933,23,57.73,215,1334,4945,-3611
1048033,5/21/2011,20110521,S24_1046,22,77.9,215,1716,4730,-3014
1027451,5/21/2011,20110521,S18_2248,42,53.88,50,2268,2100,168
1055176,5/21/2011,20110521,S24_2022,22,45.25,10,990,220,770
1100496,5/21/2011,20110521,S18_2795,34,100,75,3400,2550,850
1025540,5/21/2011,20110521,S18_1749,21,100,50,2100,1050,1050
1098144,5/21/2011,20110521,S18_1342,32,100,50,3200,1600,1600
1030868,5/21/2011,20110521,S18_2325,42,100,60,4200,2520,1680
1060338,5/21/2011,20110521,S24_2766,32,72.7,10,2336,320,2016
1075368,5/21/2011,20110521,S24_2887,25,93.95,10,2350,250,2100
1081262,5/21/2011,20110521,S24_3191,49,83.04,10,4067,490,3577
1087299,5/21/2011,20110521,S24_3432,43,100,10,4300,430,3870
1200152,5/28/2011,20110528,S24_4258,34,100,365,3400,12410,-9010
1194519,5/28/2011,20110528,S18_4668,43,53.83,215,2322,9245,-6923
1183026,5/28/2011,20110528,S18_4600,50,100,200,5000,10000,-5000
1171950,5/28/2011,20110528,S18_2957,46,73.7,90,3404,4140,-736
1182504,5/28/2011,20110528,S18_3320,38,82.34,100,3116,3800,-684
1158810,5/28/2011,20110528,S18_2432,43,65.02,70,2795,3010,-215
1179156,5/28/2011,20110528,S18_3136,30,97.39,100,2910,3000,-90
1169936,5/28/2011,20110528,S18_2949,31,90.17,90,2790,2790,0
1155271,5/28/2011,20110528,S18_1367,42,54.99,50,2310,2100,210
1216144,5/28/2011,20110528,S32_3522,26,62.7,10,1638,260,1378
1141928,5/28/2011,20110528,S12_1666,21,100,25,2100,525,1575
1134353,5/28/2011,20110528,S10_4962,22,100,25,2200,550,1650
1142145,5/28/2011,20110528,S18_1097,38,100,50,3800,1900,1900
1195087,5/28/2011,20110528,S24_2300,27,100,10,2700,270,2430
1128665,5/28/2011,20110528,S10_1949,38,100,10,3800,380,3420
1204820,5/28/2011,20110528,S32_1268,43,96.31,10,4128,430,3698
1224438,5/28/2011,20110528,S700_2824,45,100,10,4500,450,4050
1274483,6/3/2011,20110603,S24_4048,20,96.99,315,1940,6300,-4360
1273252,6/3/2011,20110603,S24_1444,20,60.69,225,1220,4500,-3280
1260653,6/3/2011,20110603,S18_4027,25,100,150,2500,3750,-1250
1255455,6/3/2011,20110603,S18_3232,22,100,100,2200,2200,0
1274232,6/3/2011,20110603,S24_2840,39,38.19,10,1482,390,1092
1250364,6/3/2011,20110603,S12_4473,24,100,40,2400,960,1440
1277580,6/3/2011,20110603,S32_3207,29,70.84,10,2059,290,1769
1252574,6/3/2011,20110603,S18_2319,45,100,60,4500,2700,1800
1276579,6/3/2011,20110603,S32_2509,45,51.95,10,2340,450,1890
1251906,6/3/2011,20110603,S18_2238,45,100,50,4500,2250,2250
1250009,6/3/2011,20110603,S12_3891,42,100,40,4200,1680,2520
1310076,6/3/2011,20110603,S50_1514,46,69.12,10,3174,460,2714
1236443,6/3/2011,20110603,S12_3148,46,100,40,4600,1840,2760
1225443,6/3/2011,20110603,S12_1108,46,100,25,4600,1150,3450
1286521,6/3/2011,20110603,S50_1392,46,100,10,4600,460,4140
1332969,6/6/2011,20110606,S18_4522,43,92.16,200,3956,8600,-4644
1319021,6/6/2011,20110606,S18_3140,41,100,100,4100,4100,0
1319474,6/6/2011,20110606,S18_3259,41,100,100,4100,4100,0
1340211,6/6/2011,20110606,S700_1938,32,97,10,3104,320,2784
1343273,6/12/2011,20110612,S24_3816,50,77.99,265,3900,13250,-9350
1345326,6/12/2011,20110612,S700_1138,31,60,10,1860,310,1550
1357015,6/12/2011,20110612,S72_3212,32,64.97,10,2080,320,1760
1354386,6/12/2011,20110612,S700_3962,30,85.41,10,2550,300,2250
1340246,6/12/2011,20110612,S10_4757,33,100,20,3300,660,2640
1350758,6/12/2011,20110612,S700_2610,45,85.29,10,3825,450,3375
1352972,6/12/2011,20110612,S700_3505,42,91.15,10,3822,420,3402
1342050,6/12/2011,20110612,S24_3151,41,94.71,10,3895,410,3485
1340595,6/12/2011,20110612,S24_2011,45,100,10,4500,450,4050
1382679,6/16/2011,20110616,S24_3949,50,81.89,415,4100,20750,-16650
1360508,6/16/2011,20110616,S18_3856,33,100,150,3300,4950,-1650
1360310,6/16/2011,20110616,S18_3029,40,96.34,90,3840,3600,240
1398634,6/16/2011,20110616,S72_1253,21,41.71,10,882,210,672
1372502,6/16/2011,20110616,S18_1662,21,100,50,2100,1050,1050
1381251,6/16/2011,20110616,S24_3420,29,59.18,10,1711,290,1421
1394504,6/16/2011,20110616,S700_4002,26,85.13,10,2210,260,1950
1377772,6/16/2011,20110616,S24_2841,35,67.14,10,2345,350,1995
1387791,6/16/2011,20110616,S700_2466,40,100,10,4000,400,3600
1401185,6/25/2011,20110625,S700_3167,36,68.8,10,2484,360,2124
1402301,6/27/2011,20110627,S24_1785,41,94.1,315,3854,12915,-9061
1402196,6/27/2011,20110627,S18_2581,49,69.27,75,3381,3675,-294
1405776,6/27/2011,20110627,S50_1341,27,50.19,10,1350,270,1080
1417736,6/27/2011,20110627,S700_1691,24,77.64,10,1872,240,1632
1404179,6/27/2011,20110627,S32_1374,23,100,10,2300,230,2070
1404547,6/27/2011,20110627,S32_4289,49,57.1,10,2793,490,2303
1419807,6/27/2011,20110627,S700_2834,27,99.67,10,2700,270,2430
1403796,6/27/2011,20110627,S24_4278,46,77.52,15,3588,690,2898
1466756,7/1/2011,20110701,S24_1578,35,93.54,240,3290,8400,-5110
1450820,7/1/2011,20110701,S18_2625,30,61.78,75,1860,2250,-390
1442399,7/1/2011,20110701,S12_2823,20,100,35,2000,700,1300
1433586,7/1/2011,20110701,S10_2016,27,100,15,2700,405,2295
1440449,7/1/2011,20110701,S10_4698,31,100,15,3100,465,2635
1473441,7/1/2011,20110701,S24_2000,43,83.03,10,3569,430,3139
1421736,7/1/2011,20110701,S10_1678,41,94.74,10,3895,410,3485
1523550,7/2/2011,20110702,S24_3856,47,100,365,4700,17155,-12455
1502228,7/2/2011,20110702,S18_4721,31,100,215,3100,6665,-3565
1501365,7/2/2011,20110702,S18_3782,45,50.36,125,2250,5625,-3375
1498857,7/2/2011,20110702,S18_3278,45,78,100,3510,4500,-990
1500892,7/2/2011,20110702,S18_3482,42,100,115,4200,4830,-630
1521131,7/2/2011,20110702,S24_2972,20,35.87,10,720,200,520
1488480,7/2/2011,20110702,S12_3990,24,75.01,40,1800,960,840
1528685,7/2/2011,20110702,S32_2206,33,40.23,10,1320,330,990
1496890,7/2/2011,20110702,S18_1889,48,79.31,50,3792,2400,1392
1514321,7/2/2011,20110702,S24_2360,29,61.64,10,1798,290,1508
1523526,7/2/2011,20110702,S24_3371,27,66.13,10,1782,270,1512
1492232,7/2/2011,20110702,S12_4675,29,97.89,45,2842,1305,1537
1526379,7/2/2011,20110702,S24_4620,23,87.31,10,2001,230,1771
1538812,7/2/2011,20110702,S32_4485,30,89.8,10,2700,300,2400
1486023,7/2/2011,20110702,S12_3380,48,100,40,4800,1920,2880
1476044,7/2/2011,20110702,S12_1099,42,100,25,4200,1050,3150
1550357,7/2/2011,20110702,S50_4713,44,96,10,4224,440,3784
1559157,7/4/2011,20110704,S18_3232,41,100,100,4100,4100,0
1551640,7/4/2011,20110704,S18_1129,25,100,50,2500,1250,1250
1554377,7/4/2011,20110704,S18_1984,36,100,50,3600,1800,1800
1671263,7/7/2011,20110707,S24_1937,22,29.21,365,638,8030,-7392
1705496,7/7/2011,20110707,S24_3969,29,38.16,265,1102,7685,-6583
1652408,7/7/2011,20110707,S24_1046,45,84.51,215,3825,9675,-5850
1642651,7/7/2011,20110707,S18_4409,47,100,200,4700,9400,-4700
1647770,7/7/2011,20110707,S18_4933,23,66.99,215,1541,4945,-3404
1622398,7/7/2011,20110707,S18_2248,22,48.43,50,1056,1100,-44
1676729,7/7/2011,20110707,S24_2022,33,43.01,10,1419,330,1089
1629153,7/7/2011,20110707,S18_2325,38,100,60,3800,2280,1520
1615134,7/7/2011,20110707,S18_1749,33,100,50,3300,1650,1650
1701841,7/7/2011,20110707,S24_3432,21,100,10,2100,210,1890
1682284,7/7/2011,20110707,S24_2766,28,100,10,2800,280,2520
1686069,7/7/2011,20110707,S24_2887,30,100,10,3000,300,2700
1689281,7/7/2011,20110707,S24_3191,49,90.75,10,4459,490,3969
1611706,7/10/2011,20110710,S24_1628,26,49.81,265,1300,6890,-5590
1602623,7/10/2011,20110710,S18_3685,31,100,115,3100,3565,-465
1573864,7/10/2011,20110710,S18_2870,37,100,75,3700,2775,925
1568261,7/10/2011,20110710,S18_1589,44,99.55,50,4400,2200,2200
1734394,7/16/2011,20110716,S24_4258,29,100,365,2900,10585,-7685
1720609,7/16/2011,20110716,S18_2957,20,71.2,90,1420,1800,-380
1710601,7/16/2011,20110716,S18_1367,49,43.13,50,2107,2450,-343
1725619,7/16/2011,20110716,S18_3136,20,90.06,100,1800,2000,-200
1732949,7/16/2011,20110716,S18_3320,30,100,100,3000,3000,0
1717753,7/16/2011,20110716,S18_2949,46,100,90,4600,4140,460
1717596,7/16/2011,20110716,S18_2795,41,100,75,4100,3075,1025
1708005,7/16/2011,20110716,S18_1342,31,100,50,3100,1550,1550
1764710,7/24/2011,20110724,S18_4668,29,43.27,215,1247,6235,-4988
1762554,7/24/2011,20110724,S18_4600,40,100,200,4000,8000,-4000
1753109,7/24/2011,20110724,S18_2432,46,61.99,70,2852,3220,-368
1797737,7/24/2011,20110724,S32_3522,28,60.76,10,1708,280,1428
1746425,7/24/2011,20110724,S18_1097,32,100,50,3200,1600,1600
1742252,7/24/2011,20110724,S10_4962,26,100,25,2600,650,1950
1779665,7/24/2011,20110724,S32_1268,26,100,10,2600,260,2340
1744100,7/24/2011,20110724,S12_1666,38,100,25,3800,950,2850
1800583,7/24/2011,20110724,S700_2824,36,100,10,3600,360,3240
1734630,7/24/2011,20110724,S10_1949,37,100,10,3700,370,3330
1777614,7/24/2011,20110724,S24_2300,47,100,10,4700,470,4230
1846515,8/1/2011,20110801,S24_4048,40,94.62,315,3800,12600,-8800
1832047,8/1/2011,20110801,S24_1444,20,54.33,225,1080,4500,-3420
1830288,8/1/2011,20110801,S18_3232,34,100,100,3400,3400,0
1842622,8/1/2011,20110801,S24_2840,21,42.43,10,882,210,672
1846988,8/1/2011,20110801,S32_2509,24,45.99,10,1104,240,864
1802524,8/1/2011,20110801,S12_4473,21,100,40,2100,840,1260
1829598,8/1/2011,20110801,S18_2319,47,100,60,4700,2820,1880
1812744,8/1/2011,20110801,S18_2238,39,100,50,3900,1950,1950
1865431,8/1/2011,20110801,S50_1392,44,100,10,4400,440,3960
1884532,8/8/2011,20110808,S18_4522,24,70.22,200,1680,4800,-3120
1883777,8/8/2011,20110808,S18_4027,24,100,150,2400,3600,-1200
1883404,8/8/2011,20110808,S18_3259,22,97.81,100,2156,2200,-44
1880684,8/8/2011,20110808,S18_3140,47,100,100,4700,4700,0
1970931,8/8/2011,20110808,S72_3212,39,44.23,10,1716,390,1326
1918297,8/8/2011,20110808,S50_1514,42,49.79,10,2100,420,1680
1926865,8/8/2011,20110808,S700_3505,21,100,10,2100,210,1890
1876855,8/8/2011,20110808,S12_3148,33,100,40,3300,1320,1980
1922846,8/8/2011,20110808,S700_1138,41,64,10,2624,410,2214
1871317,8/8/2011,20110808,S12_1108,33,100,25,3300,825,2475
1916163,8/8/2011,20110808,S32_3207,42,74.57,10,3150,420,2730
1879921,8/8/2011,20110808,S12_3891,46,100,40,4600,1840,2760
1936691,8/8/2011,20110808,S700_3962,38,85.41,10,3230,380,2850
1890660,8/8/2011,20110808,S24_2011,33,100,10,3300,330,2970
1923017,8/8/2011,20110808,S700_1938,43,84.01,10,3612,430,3182
1910798,8/8/2011,20110808,S24_3151,49,98.25,10,4802,490,4312
2001745,8/10/2011,20110810,S24_3949,28,66.19,415,1848,11620,-9772
1998785,8/10/2011,20110810,S24_3816,23,80.51,265,1863,6095,-4232
1986758,8/10/2011,20110810,S18_3856,34,100,150,3400,5100,-1700
1985182,8/10/2011,20110810,S18_3029,46,74.84,90,3450,4140,-690
2006707,8/10/2011,20110810,S50_1341,34,36.66,10,1258,340,918
1987475,8/10/2011,20110810,S24_2841,27,60.97,10,1647,270,1377
2063406,8/10/2011,20110810,S72_1253,37,50.65,10,1887,370,1517
1981068,8/10/2011,20110810,S18_1662,32,100,50,3200,1600,1600
2035482,8/10/2011,20110810,S700_2466,26,82.77,10,2158,260,1898
1995798,8/10/2011,20110810,S24_3420,33,77.59,10,2574,330,2244
2048196,8/10/2011,20110810,S700_2610,31,85.29,10,2635,310,2325
2051678,8/10/2011,20110810,S700_3167,28,96,10,2688,280,2408
2061286,8/10/2011,20110810,S700_4002,34,85.87,10,2924,340,2584
2019082,8/10/2011,20110810,S700_1691,36,100,10,3600,360,3240
1978238,8/10/2011,20110810,S10_4757,49,100,20,4900,980,3920
2072080,8/13/2011,20110813,S32_4289,20,81.86,10,1640,200,1440
2155724,8/25/2011,20110825,S24_1785,40,87.54,315,3520,12600,-9080
2151646,8/25/2011,20110825,S24_1578,43,95.8,240,4128,10320,-6192
2122301,8/25/2011,20110825,S18_2625,30,49.67,75,1500,2250,-750
2101456,8/25/2011,20110825,S18_2581,30,85.32,75,2550,2250,300
2181021,8/25/2011,20110825,S32_2206,31,35.8,10,1116,310,806
2165788,8/25/2011,20110825,S24_2360,27,60.95,10,1647,270,1377
2211759,8/25/2011,20110825,S700_2834,20,100,10,2000,200,1800
2173435,8/25/2011,20110825,S24_4278,33,84.77,15,2805,495,2310
2198907,8/25/2011,20110825,S32_4485,27,100,10,2700,270,2430
2207717,8/25/2011,20110825,S50_4713,38,81.36,10,3078,380,2698
2176556,8/25/2011,20110825,S32_1374,33,93.9,10,3102,330,2772
2095121,8/25/2011,20110825,S10_4698,33,100,15,3300,495,2805
2083631,8/25/2011,20110825,S10_2016,37,100,15,3700,555,3145
2096899,8/25/2011,20110825,S12_2823,49,100,35,4900,1715,3185
2077610,8/25/2011,20110825,S10_1678,45,83.26,10,3735,450,3285
2163663,8/25/2011,20110825,S24_2000,47,83.03,10,3901,470,3431
2217702,9/3/2011,20110903,S18_4721,29,100,215,2900,6235,-3335
2213367,9/3/2011,20110903,S18_3782,47,67.14,125,3149,5875,-2726
2245632,9/5/2011,20110905,S24_3856,23,100,365,2300,8395,-6095
2242755,9/5/2011,20110905,S18_3482,37,100,115,3700,4255,-555
2232905,9/5/2011,20110905,S18_3278,36,86.04,100,3096,3600,-504
2223642,9/5/2011,20110905,S12_3990,21,63.84,40,1344,840,504
2243064,9/5/2011,20110905,S24_2972,25,42.67,10,1075,250,825
2228619,9/5/2011,20110905,S18_1889,26,82.39,50,2132,1300,832
2261838,9/5/2011,20110905,S24_4620,31,64.67,10,2015,310,1705
2228187,9/5/2011,20110905,S12_4675,33,97.89,45,3234,1485,1749
2245578,9/5/2011,20110905,S24_3371,30,68.58,10,2070,300,1770
2223311,9/5/2011,20110905,S12_3380,31,100,40,3100,1240,1860
2220541,9/5/2011,20110905,S12_1099,48,100,25,4800,1200,3600
2331070,9/11/2011,20110911,S24_1628,47,56.85,265,2679,12455,-9776
2320739,9/11/2011,20110911,S18_4933,29,81.25,215,2349,6235,-3886
2329098,9/11/2011,20110911,S24_1046,25,60.26,215,1500,5375,-3875
2309245,9/11/2011,20110911,S18_4409,34,100,200,3400,6800,-3400
2307655,9/11/2011,20110911,S18_3685,28,100,115,2800,3220,-420
2306301,9/11/2011,20110911,S18_3232,32,100,100,3200,3200,0
2305407,9/11/2011,20110911,S18_2870,27,100,75,2700,2025,675
2272727,9/11/2011,20110911,S18_1129,23,100,50,2300,1150,1150
2298433,9/11/2011,20110911,S18_1984,25,100,50,2500,1250,1250
2368846,9/11/2011,20110911,S24_2766,21,73.6,10,1554,210,1344
2382546,9/11/2011,20110911,S24_3191,31,73.62,10,2294,310,1984
2294805,9/11/2011,20110911,S18_1589,47,100,50,4700,2350,2350
2384555,9/11/2011,20110911,S24_3432,27,100,10,2700,270,2430
2372445,9/11/2011,20110911,S24_2887,34,100,10,3400,340,3060
2413741,9/12/2011,20110912,S24_1937,36,33.19,365,1188,13140,-11952
2423328,9/12/2011,20110912,S24_3969,26,38.98,265,1014,6890,-5876
2440205,9/12/2011,20110912,S24_4258,20,90.57,365,1820,7300,-5480
2409899,9/12/2011,20110912,S18_3320,42,94.25,100,3948,4200,-252
2388597,9/12/2011,20110912,S18_1367,30,58.22,50,1740,1500,240
2392990,9/12/2011,20110912,S18_2248,24,62.36,50,1488,1200,288
2406656,9/12/2011,20110912,S18_2795,23,100,75,2300,1725,575
2393201,9/12/2011,20110912,S18_2325,33,100,60,3300,1980,1320
2391475,9/12/2011,20110912,S18_1749,34,100,50,3400,1700,1700
2422670,9/12/2011,20110912,S24_2022,49,49.28,10,2401,490,1911
2387124,9/12/2011,20110912,S18_1342,50,100,50,5000,2500,2500
2495151,9/19/2011,20110919,S18_4668,30,42.76,215,1290,6450,-5160
2473728,9/19/2011,20110919,S18_4600,49,100,200,4900,9800,-4900
2455332,9/19/2011,20110919,S18_2957,30,49.97,90,1500,2700,-1200
2459553,9/19/2011,20110919,S18_3136,26,100,100,2600,2600,0
2454935,9/19/2011,20110919,S18_2949,47,91.18,90,4277,4230,47
2441650,9/19/2011,20110919,S10_4962,20,100,25,2000,500,1500
2451446,9/19/2011,20110919,S18_1097,34,100,50,3400,1700,1700
2503153,9/19/2011,20110919,S700_2824,20,100,10,2000,200,1800
2446893,9/19/2011,20110919,S12_1666,30,100,25,3000,750,2250
2499884,9/19/2011,20110919,S32_3522,49,58.18,10,2842,490,2352
2440652,9/19/2011,20110919,S10_1949,45,100,10,4500,450,4050
2538720,9/21/2011,20110921,S18_2432,39,69.28,70,2691,2730,-39
2543662,9/21/2011,20110921,S18_3232,21,100,100,2100,2100,0
2545084,9/21/2011,20110921,S24_2840,30,40.31,10,1200,300,900
2523015,9/21/2011,20110921,S12_4473,24,100,40,2400,960,1440
2535155,9/21/2011,20110921,S18_2319,49,100,60,4900,2940,1960
2526441,9/21/2011,20110921,S18_2238,43,100,50,4300,2150,2150
2549245,9/21/2011,20110921,S32_2509,41,63.85,10,2624,410,2214
2552500,9/21/2011,20110921,S50_1392,26,100,10,2600,260,2340
2548018,9/21/2011,20110921,S32_1268,27,100,10,2700,270,2430
2543821,9/21/2011,20110921,S24_2300,42,100,10,4200,420,3780
2566736,9/25/2011,20110925,S24_4048,23,100,315,2300,7245,-4945
2559426,9/25/2011,20110925,S24_1444,25,65.31,225,1625,5625,-4000
2552577,9/25/2011,20110925,S18_4027,35,100,150,3500,5250,-1750
2569306,9/25/2011,20110925,S32_3207,33,50.95,10,1683,330,1353
2636067,9/28/2011,20110928,S18_4522,22,83.38,200,1826,4400,-2574
2622832,9/28/2011,20110928,S18_3259,29,88.74,100,2581,2900,-319
2615813,9/28/2011,20110928,S18_3140,31,100,100,3100,3100,0
2651114,9/28/2011,20110928,S50_1514,31,57.41,10,1767,310,1457
2573867,9/28/2011,20110928,S12_1108,20,100,25,2000,500,1500
2660833,9/28/2011,20110928,S700_3962,20,100,10,2000,200,1800
2652492,9/28/2011,20110928,S700_1138,43,64.67,10,2795,430,2365
2653857,9/28/2011,20110928,S700_1938,31,87.48,10,2697,310,2387
2688732,9/28/2011,20110928,S72_3212,50,60.06,10,3000,500,2500
2574054,9/28/2011,20110928,S12_3148,42,100,40,4200,1680,2520
2601158,9/28/2011,20110928,S12_3891,49,100,40,4900,1960,2940
2637693,9/28/2011,20110928,S24_2011,40,100,10,4000,400,3600
2655286,9/28/2011,20110928,S700_3505,50,88.15,10,4400,500,3900
2724184,10/2/2011,20111002,S700_2610,36,64.33,10,2304,360,1944
2710614,10/2/2011,20111002,S24_3151,31,91.17,10,2821,310,2511
530995,10/6/2011,20111006,S24_3949,44,77.11,415,3388,18260,-14872
2749869,10/6/2011,20111006,S24_3816,37,67.93,265,2516,9805,-7289
2746907,10/6/2011,20111006,S18_3856,29,100,150,2900,4350,-1450
2746446,10/6/2011,20111006,S18_3029,44,79.14,90,3476,3960,-484
540832,10/6/2011,20111006,S72_1253,34,49.16,10,1666,340,1326
2748530,10/6/2011,20111006,S24_2841,23,72.62,10,1679,230,1449
2749516,10/6/2011,20111006,S24_3420,34,55.89,10,1904,340,1564
534647,10/6/2011,20111006,S700_2466,20,100,10,2000,200,1800
2745111,10/6/2011,20111006,S18_1662,38,100,50,3800,1900,1900
2725567,10/6/2011,20111006,S10_4757,32,100,20,3200,640,2560
537814,10/6/2011,20111006,S700_3167,43,86.4,10,3698,430,3268
540787,10/6/2011,20111006,S700_4002,44,85.87,10,3784,440,3344
543009,10/8/2011,20111008,S50_1341,20,41.02,10,820,200,620
543201,10/8/2011,20111008,S700_1691,48,100,10,4800,480,4320
549100,10/9/2011,20111009,S24_1785,40,100,315,4000,12600,-8600
548157,10/9/2011,20111009,S18_2581,33,78.57,75,2607,2475,132
564993,10/9/2011,20111009,S32_4289,28,74.98,10,2100,280,1820
551672,10/9/2011,20111009,S24_4278,33,86.22,15,2838,495,2343
563249,10/9/2011,20111009,S32_1374,34,100,10,3400,340,3060
566908,10/9/2011,20111009,S700_2834,48,100,10,4800,480,4320
651411,10/10/2011,20111010,S24_1578,44,100,240,4400,10560,-6160
636158,10/10/2011,20111010,S18_4721,32,100,215,3200,6880,-3680
626710,10/10/2011,20111010,S18_3782,21,64.66,125,1365,2625,-1260
616491,10/10/2011,20111010,S18_2625,42,51.48,75,2142,3150,-1008
620576,10/10/2011,20111010,S18_3278,21,81.21,100,1701,2100,-399
624153,10/10/2011,20111010,S18_3482,25,100,115,2500,2875,-375
614475,10/10/2011,20111010,S12_3990,24,73.42,40,1752,960,792
654337,10/10/2011,20111010,S32_2206,35,35.4,10,1225,350,875
578998,10/10/2011,20111010,S24_2000,22,67.03,10,1474,220,1254
652865,10/10/2011,20111010,S24_4620,23,67.1,10,1541,230,1311
601230,10/10/2011,20111010,S10_4698,22,100,15,2200,330,1870
652111,10/10/2011,20111010,S24_2360,27,80.34,10,2160,270,1890
665357,10/10/2011,20111010,S50_4713,31,71.6,10,2232,310,1922
664679,10/10/2011,20111010,S32_4485,23,100,10,2300,230,2070
613368,10/10/2011,20111010,S12_2823,38,100,35,3800,1330,2470
652746,10/10/2011,20111010,S24_3371,50,69.8,10,3500,500,3000
608219,10/10/2011,20111010,S12_1099,41,100,25,4100,1025,3075
594860,10/10/2011,20111010,S10_2016,37,100,15,3700,555,3145
592732,10/10/2011,20111010,S10_1678,49,100,10,4900,490,4410
698405,10/11/2011,20111011,S24_3856,35,100,365,3500,12775,-9275
697281,10/11/2011,20111011,S18_3232,20,100,100,2000,2000,0
697671,10/11/2011,20111011,S24_2972,42,37,10,1554,420,1134
691290,10/11/2011,20111011,S18_1889,38,88.55,50,3382,1900,1482
689530,10/11/2011,20111011,S12_4675,50,100,45,5000,2250,2750
671965,10/11/2011,20111011,S12_3380,46,100,40,4600,1840,2760
738456,10/17/2011,20111017,S24_1046,37,72.76,215,2701,7955,-5254
740076,10/17/2011,20111017,S24_1628,23,53.33,265,1219,6095,-4876
730852,10/17/2011,20111017,S18_4933,25,80.54,215,2025,5375,-3350
714399,10/17/2011,20111017,S18_3685,36,100,115,3600,4140,-540
712931,10/17/2011,20111017,S18_2870,23,100,75,2300,1725,575
773262,10/17/2011,20111017,S24_3191,20,77.05,10,1540,200,1340
706483,10/17/2011,20111017,S18_1129,28,100,50,2800,1400,1400
740289,10/17/2011,20111017,S24_2766,20,100,10,2000,200,1800
708668,10/17/2011,20111017,S18_1589,43,100,50,4300,2150,2150
750757,10/17/2011,20111017,S24_2887,25,100,10,2500,250,2250
711195,10/17/2011,20111017,S18_1984,48,100,50,4800,2400,2400
773604,10/17/2011,20111017,S24_3432,30,100,10,3000,300,2700
804444,10/18/2011,20111018,S24_1937,37,27.22,365,999,13505,-12506
814425,10/18/2011,20111018,S24_3969,37,38.98,265,1443,9805,-8362
804230,10/18/2011,20111018,S18_4409,39,100,200,3900,7800,-3900
778479,10/18/2011,20111018,S18_1367,45,51.21,50,2295,2250,45
785977,10/18/2011,20111018,S18_2248,27,69.62,50,1890,1350,540
806801,10/18/2011,20111018,S24_2022,43,36.29,10,1548,430,1118
796677,10/18/2011,20111018,S18_2795,48,100,75,4800,3600,1200
785172,10/18/2011,20111018,S18_1749,29,100,50,2900,1450,1450
790818,10/18/2011,20111018,S18_2325,38,100,60,3800,2280,1520
776797,10/18/2011,20111018,S18_1342,48,91.44,50,4368,2400,1968
857829,10/20/2011,20111020,S24_4258,42,91.55,365,3864,15330,-11466
832752,10/20/2011,20111020,S18_2957,48,69.96,90,3360,4320,-960
844025,10/20/2011,20111020,S18_3136,40,100,100,4000,4000,0
857544,10/20/2011,20111020,S18_3320,43,100,100,4300,4300,0
822845,10/20/2011,20111020,S18_2949,31,100,90,3100,2790,310
815893,10/20/2011,20111020,S10_1949,21,100,10,2100,210,1890
880141,10/21/2011,20111021,S18_4600,45,100,200,4500,9000,-4500
881506,10/21/2011,20111021,S18_4668,25,53.83,215,1350,5375,-4025
1003290,10/21/2011,20111021,S18_4522,26,73.73,200,1924,5200,-3276
1000465,10/21/2011,20111021,S18_3140,43,100,100,4300,4300,0
860805,10/21/2011,20111021,S10_4962,21,100,25,2100,525,1575
865794,10/21/2011,20111021,S18_1097,36,99.17,50,3564,1800,1764
889391,10/21/2011,20111021,S32_1268,24,100,10,2400,240,2160
900024,10/21/2011,20111021,S32_3522,49,54.94,10,2695,490,2205
1007769,10/21/2011,20111021,S700_1938,29,100,10,2900,290,2610
910285,10/21/2011,20111021,S700_2824,39,81.93,10,3198,390,2808
863963,10/21/2011,20111021,S12_1666,49,100,25,4900,1225,3675
987986,10/22/2011,20111022,S24_4048,24,99.36,315,2376,7560,-5184
974546,10/22/2011,20111022,S24_1444,25,69.36,225,1725,5625,-3900
973746,10/22/2011,20111022,S18_4027,28,100,150,2800,4200,-1400
955015,10/22/2011,20111022,S18_3232,47,100,100,4700,4700,0
967274,10/22/2011,20111022,S18_3259,50,100,100,5000,5000,0
934318,10/22/2011,20111022,S18_2432,31,71.1,70,2201,2170,31
976679,10/22/2011,20111022,S24_2840,27,31.82,10,864,270,594
929744,10/22/2011,20111022,S18_2238,29,100,50,2900,1450,1450
923868,10/22/2011,20111022,S12_3891,27,100,40,2700,1080,1620
989103,10/22/2011,20111022,S32_2509,48,45.99,10,2208,480,1728
932562,10/22/2011,20111022,S18_2319,46,100,60,4600,2760,1840
989926,10/22/2011,20111022,S32_3207,44,53.44,10,2332,440,1892
922428,10/22/2011,20111022,S12_3148,34,100,40,3400,1360,2040
994336,10/22/2011,20111022,S50_1514,38,66.78,10,2546,380,2166
927435,10/22/2011,20111022,S12_4473,48,100,40,4800,1920,2880
976031,10/22/2011,20111022,S24_2300,32,100,10,3200,320,2880
918775,10/22/2011,20111022,S12_1108,44,100,25,4400,1100,3300
992260,10/22/2011,20111022,S50_1392,48,94.92,10,4560,480,4080
1048033,10/23/2011,20111023,S24_3816,29,83.86,265,2436,7685,-5249
1025540,10/23/2011,20111023,S18_3856,34,100,150,3400,5100,-1700
1024249,10/23/2011,20111023,S18_3029,46,73.12,90,3358,4140,-782
1030868,10/23/2011,20111023,S24_2841,21,69.88,10,1470,210,1260
1087299,10/23/2011,20111023,S72_1253,40,41.71,10,1680,400,1280
1037456,10/23/2011,20111023,S24_3151,20,79.66,10,1600,200,1400
1092158,10/23/2011,20111023,S72_3212,38,48.59,10,1862,380,1482
1038028,10/23/2011,20111023,S24_3420,32,63.12,10,2016,320,1696
1020435,10/23/2011,20111023,S18_1662,43,100,50,4300,2150,2150
1075368,10/23/2011,20111023,S700_3505,24,100,10,2400,240,2160
1081262,10/23/2011,20111023,S700_3962,28,100,10,2800,280,2520
1060338,10/23/2011,20111023,S700_2610,46,70.11,10,3220,460,2760
1053395,10/23/2011,20111023,S700_1138,43,75.34,10,3225,430,2795
1027451,10/23/2011,20111023,S24_2011,33,100,10,3300,330,2970
1013812,10/23/2011,20111023,S10_4757,44,100,20,4400,880,3520
1155271,10/28/2011,20111028,S24_1785,49,100,315,4900,15435,-10535
1169936,10/28/2011,20111028,S24_3949,27,73.02,415,1971,11205,-9234
1142145,10/28/2011,20111028,S24_1578,50,100,240,5000,12000,-7000
1141928,10/28/2011,20111028,S18_2625,46,61.18,75,2806,3450,-644
1134353,10/28/2011,20111028,S18_2581,21,70.96,75,1491,1575,-84
1128665,10/28/2011,20111028,S10_4698,20,100,15,2000,300,1700
1158810,10/28/2011,20111028,S24_2000,29,75.41,10,2175,290,1885
1182504,10/28/2011,20111028,S32_4289,31,73.61,10,2294,310,1984
1183026,10/28/2011,20111028,S50_1341,48,51.93,10,2496,480,2016
1100496,10/28/2011,20111028,S10_2016,27,100,15,2700,405,2295
1194519,10/28/2011,20111028,S700_1691,28,98.65,10,2772,280,2492
1179156,10/28/2011,20111028,S32_1374,28,100,10,2800,280,2520
1195087,10/28/2011,20111028,S700_2466,31,100,10,3100,310,2790
1216144,10/28/2011,20111028,S700_4002,39,82.91,10,3237,390,2847
1171950,10/28/2011,20111028,S24_4278,48,78.25,15,3744,720,3024
1098144,10/28/2011,20111028,S10_1678,36,96.66,10,3492,360,3132
1200152,10/28/2011,20111028,S700_2834,36,100,10,3600,360,3240
1204820,10/28/2011,20111028,S700_3167,48,96,10,4608,480,4128
1319021,11/4/2011,20111104,S24_3856,34,100,365,3400,12410,-9010
1252574,11/4/2011,20111104,S18_4721,33,100,215,3300,7095,-3795
1251906,11/4/2011,20111104,S18_3782,38,68.39,125,2584,4750,-2166
1250009,11/4/2011,20111104,S18_3278,32,70.76,100,2272,3200,-928
1250364,11/4/2011,20111104,S18_3482,36,100,115,3600,4140,-540
1310076,11/4/2011,20111104,S18_1889,20,63.14,50,1260,1000,260
1274232,11/4/2011,20111104,S32_2206,26,39.83,10,1040,260,780
1236443,11/4/2011,20111104,S12_3990,36,63.84,40,2304,1440,864
1260653,11/4/2011,20111104,S24_3371,34,50.21,10,1700,340,1360
1273252,11/4/2011,20111104,S24_4620,24,94.58,10,2280,240,2040
1224438,11/4/2011,20111104,S12_1099,30,100,25,3000,750,2250
1286521,11/4/2011,20111104,S12_4675,41,100,45,4100,1845,2255
1225443,11/4/2011,20111104,S12_2823,35,100,35,3500,1225,2275
1255455,11/4/2011,20111104,S24_2360,38,74.11,10,2812,380,2432
1277580,11/4/2011,20111104,S12_3380,47,100,40,4700,1880,2820
1274483,11/4/2011,20111104,S32_4485,34,100,10,3400,340,3060
1276579,11/4/2011,20111104,S50_4713,48,80.55,10,3888,480,3408
1402196,11/5/2011,20111105,S24_1937,31,31.53,365,992,11315,-10323
1404179,11/5/2011,20111105,S24_3969,35,33.23,265,1155,9275,-8120
1350758,11/5/2011,20111105,S24_1628,34,42.76,265,1462,9010,-7548
1404547,11/5/2011,20111105,S24_4258,22,100,365,2200,8030,-5830
1401185,11/5/2011,20111105,S18_4933,39,71.98,215,2808,8385,-5577
1345326,11/5/2011,20111105,S24_1046,32,75.69,215,2432,6880,-4448
1398634,11/5/2011,20111105,S18_4409,21,75.46,200,1575,4200,-2625
1385910,11/5/2011,20111105,S18_2957,28,53.72,90,1512,2520,-1008
1343273,11/5/2011,20111105,S18_3685,48,100,115,4800,5520,-720
1387791,11/5/2011,20111105,S18_3136,31,89.01,100,2759,3100,-341
1360508,11/5/2011,20111105,S18_1367,48,44.21,50,2112,2400,-288
1394504,11/5/2011,20111105,S18_3320,29,95.24,100,2755,2900,-145
1340211,11/5/2011,20111105,S18_3232,39,100,100,3900,3900,0
1377772,11/5/2011,20111105,S18_2248,26,57.51,50,1508,1300,208
1382679,11/5/2011,20111105,S18_2795,22,100,75,2200,1650,550
1402301,11/5/2011,20111105,S24_2022,27,41.22,10,1107,270,837
1340246,11/5/2011,20111105,S24_2972,36,35.49,10,1260,360,900
1342050,11/5/2011,20111105,S18_2870,39,100,75,3900,2925,975
1372502,11/5/2011,20111105,S18_1749,24,100,50,2400,1200,1200
1381251,11/5/2011,20111105,S18_2325,31,100,60,3100,1860,1240
1352972,11/5/2011,20111105,S24_2766,22,74.51,10,1650,220,1430
1354386,11/5/2011,20111105,S24_3191,24,81.33,10,1944,240,1704
1319474,11/5/2011,20111105,S18_1129,35,100,50,3500,1750,1750
1332969,11/5/2011,20111105,S18_1984,35,100,50,3500,1750,1750
1357015,11/5/2011,20111105,S24_3432,22,98.51,10,2178,220,1958
1403796,11/5/2011,20111105,S24_2887,23,100,10,2300,230,2070
1340595,11/5/2011,20111105,S18_1589,42,100,50,4200,2100,2100
1360310,11/5/2011,20111105,S18_1342,43,100,50,4300,2150,2150
1433586,11/6/2011,20111106,S18_4668,49,44.78,215,2205,10535,-8330
1526379,11/6/2011,20111106,S24_4048,29,100,315,2900,9135,-6235
1476044,11/6/2011,20111106,S18_4600,47,100,200,4700,9400,-4700
1523550,11/6/2011,20111106,S24_1444,27,68.78,225,1863,6075,-4212
1523526,11/6/2011,20111106,S18_4027,36,100,150,3600,5400,-1800
1466756,11/6/2011,20111106,S18_2432,41,69.28,70,2829,2870,-41
1473441,11/6/2011,20111106,S18_3232,29,100,100,2900,2900,0
1421736,11/6/2011,20111106,S18_2949,46,100,90,4600,4140,460
1488480,11/6/2011,20111106,S24_2840,37,31.12,10,1147,370,777
1521131,11/6/2011,20111106,S18_2238,20,100,50,2000,1000,1000
1528685,11/6/2011,20111106,S32_3207,22,64,10,1408,220,1188
1442399,11/6/2011,20111106,S12_4473,26,100,40,2600,1040,1560
1498857,11/6/2011,20111106,S32_3522,29,74.98,10,2175,290,1885
1450820,11/6/2011,20111106,S18_2319,48,100,60,4800,2880,1920
1492232,11/6/2011,20111106,S32_1268,22,100,10,2200,220,1980
1550357,11/6/2011,20111106,S50_1514,38,64.44,10,2432,380,2052
1419807,11/6/2011,20111106,S18_1097,48,93.34,50,4464,2400,2064
1538812,11/6/2011,20111106,S50_1392,23,100,10,2300,230,2070
1440449,11/6/2011,20111106,S10_4962,33,100,25,3300,825,2475
1501365,11/6/2011,20111106,S12_1108,33,100,25,3300,825,2475
1486023,11/6/2011,20111106,S24_2300,28,100,10,2800,280,2520
1496890,11/6/2011,20111106,S32_2509,50,63.31,10,3150,500,2650
1502228,11/6/2011,20111106,S12_3148,47,100,40,4700,1880,2820
1514321,11/6/2011,20111106,S12_3891,50,100,40,5000,2000,3000
1405776,11/6/2011,20111106,S10_1949,34,100,10,3400,340,3060
1500892,11/6/2011,20111106,S700_2824,42,85.98,10,3612,420,3192
1417736,11/6/2011,20111106,S12_1666,43,100,25,4300,1075,3225
1559157,11/7/2011,20111107,S18_4522,35,74.6,200,2625,7000,-4375
1551640,11/7/2011,20111107,S18_3140,23,100,100,2300,2300,0
1554377,11/7/2011,20111107,S18_3259,29,100,100,2900,2900,0
1602623,11/7/2011,20111107,S700_1138,24,76,10,1824,240,1584
1642651,11/7/2011,20111107,S72_3212,40,50.23,10,2000,400,1600
1615134,11/7/2011,20111107,S700_2610,32,76.62,10,2464,320,2144
1629153,11/7/2011,20111107,S700_3962,24,100,10,2400,240,2160
1611706,11/7/2011,20111107,S700_1938,31,88.34,10,2728,310,2418
1573864,11/7/2011,20111107,S24_3151,45,72.58,10,3285,450,2835
1622398,11/7/2011,20111107,S700_3505,44,92.16,10,4048,440,3608
1568261,11/7/2011,20111107,S24_2011,50,100,10,5000,500,4500
1701841,11/8/2011,20111108,S24_3949,30,72.33,415,2160,12450,-10290
1689281,11/8/2011,20111108,S24_3816,21,72.12,265,1512,5565,-4053
1676729,11/8/2011,20111108,S18_3856,48,100,150,4800,7200,-2400
1671263,11/8/2011,20111108,S18_3029,41,81.72,90,3362,3690,-328
1708005,11/8/2011,20111108,S700_2466,22,87.75,10,1936,220,1716
1686069,11/8/2011,20111108,S24_3420,27,73.64,10,1998,270,1728
1717596,11/8/2011,20111108,S72_1253,45,51.15,10,2295,450,1845
1647770,11/8/2011,20111108,S10_4757,24,100,20,2400,480,1920
1652408,11/8/2011,20111108,S18_1662,42,100,50,4200,2100,2100
1682284,11/8/2011,20111108,S24_2841,34,80.84,10,2754,340,2414
1710601,11/8/2011,20111108,S700_4002,45,76.25,10,3420,450,2970
1720609,11/11/2011,20111111,S24_1785,47,100,315,4700,14805,-10105
1802524,11/11/2011,20111111,S24_1578,48,100,240,4800,11520,-6720
1800583,11/11/2011,20111111,S18_4721,44,100,215,4400,9460,-5060
1797737,11/11/2011,20111111,S18_3782,21,50.36,125,1050,2625,-1575
1779665,11/11/2011,20111111,S18_2625,25,64.2,75,1600,1875,-275
1717753,11/11/2011,20111111,S18_2581,24,78.57,75,1896,1800,96
1734630,11/11/2011,20111111,S50_1341,34,42.77,10,1462,340,1122
1832047,11/11/2011,20111111,S32_2206,34,45.46,10,1530,340,1190
1734394,11/11/2011,20111111,S32_4289,24,72.23,10,1728,240,1488
1812744,11/11/2011,20111111,S24_2000,28,68.55,10,1932,280,1652
1830288,11/11/2011,20111111,S24_4620,28,71.14,10,1988,280,1708
1846515,11/11/2011,20111111,S50_4713,21,93.56,10,1974,210,1764
1725619,11/11/2011,20111111,S24_4278,27,84.77,15,2295,405,1890
1842622,11/11/2011,20111111,S32_4485,22,100,10,2200,220,1980
1742252,11/11/2011,20111111,S700_1691,23,100,10,2300,230,2070
1829598,11/11/2011,20111111,S24_2360,35,72.03,10,2520,350,2170
1753109,11/11/2011,20111111,S10_1678,29,86.13,10,2494,290,2204
1744100,11/11/2011,20111111,S700_2834,25,100,10,2500,250,2250
1746425,11/11/2011,20111111,S700_3167,39,68.8,10,2691,390,2301
1777614,11/11/2011,20111111,S12_2823,40,100,35,4000,1400,2600
1764710,11/11/2011,20111111,S10_4698,41,100,15,4100,615,3485
1762554,11/11/2011,20111111,S10_2016,42,100,15,4200,630,3570
1732949,11/11/2011,20111111,S32_1374,45,100,10,4500,450,4050
2019082,11/12/2011,20111112,S24_1937,39,36.84,365,1443,14235,-12792
1922846,11/12/2011,20111112,S24_1628,34,53.83,265,1836,9010,-7174
2006707,11/12/2011,20111112,S24_1046,47,74.22,215,3478,10105,-6627
1936691,11/12/2011,20111112,S24_3856,25,100,365,2500,9125,-6625
2001745,11/12/2011,20111112,S18_4933,44,69.84,215,3080,9460,-6380
2063406,11/12/2011,20111112,S24_3969,23,42.26,265,966,6095,-5129
1998785,11/12/2011,20111112,S18_4409,36,100,200,3600,7200,-3600
1918297,11/12/2011,20111112,S18_3685,39,100,115,3900,4485,-585
1910798,11/12/2011,20111112,S18_3278,30,82.82,100,2490,3000,-510
1995798,11/12/2011,20111112,S18_3320,33,86.31,100,2838,3300,-462
1916163,11/12/2011,20111112,S18_3482,22,100,115,2200,2530,-330
1890660,11/12/2011,20111112,S18_3232,45,100,100,4500,4500,0
1978238,11/12/2011,20111112,S18_1367,32,54.45,50,1728,1600,128
1985182,11/12/2011,20111112,S18_2248,38,61.15,50,2318,1900,418
1987475,11/12/2011,20111112,S18_2795,21,100,75,2100,1575,525
1883404,11/12/2011,20111112,S18_1889,22,73.92,50,1628,1100,528
1884532,11/12/2011,20111112,S18_2870,27,100,75,2700,2025,675
1986758,11/12/2011,20111112,S18_2325,20,100,60,2000,1200,800
1871317,11/12/2011,20111112,S12_3990,20,81.4,40,1620,800,820
2023334,11/12/2011,20111112,S24_2022,31,36.74,10,1147,310,837
1970931,11/12/2011,20111112,S18_1342,25,87.33,50,2175,1250,925
1883777,11/12/2011,20111112,S18_1984,21,100,50,2100,1050,1050
1923017,11/12/2011,20111112,S24_2972,37,42.67,10,1591,370,1221
1926865,11/12/2011,20111112,S24_3371,23,65.52,10,1518,230,1288
1865431,11/12/2011,20111112,S12_3380,28,100,40,2800,1120,1680
2048196,11/12/2011,20111112,S24_2887,20,100,10,2000,200,1800
1876855,11/12/2011,20111112,S12_4675,36,100,45,3600,1620,1980
1846988,11/12/2011,20111112,S12_1099,27,100,25,2700,675,2025
1880684,11/12/2011,20111112,S18_1589,42,100,50,4200,2100,2100
1879921,11/12/2011,20111112,S18_1129,44,100,50,4400,2200,2200
1981068,11/12/2011,20111112,S18_1749,44,100,50,4400,2200,2200
2035482,11/12/2011,20111112,S24_2766,36,73.6,10,2664,360,2304
2051678,11/12/2011,20111112,S24_3191,33,94.17,10,3102,330,2772
2061286,11/12/2011,20111112,S24_3432,49,100,10,4900,490,4410
2163663,11/13/2011,20111113,S24_4258,47,100,365,4700,17155,-12455
2155724,11/13/2011,20111113,S18_4668,40,49.3,215,1960,8600,-6640
2151646,11/13/2011,20111113,S18_4600,21,100,200,2100,4200,-2100
2101456,11/13/2011,20111113,S18_2957,39,68.08,90,2652,3510,-858
2096899,11/13/2011,20111113,S18_2949,37,89.15,90,3293,3330,-37
2122301,11/13/2011,20111113,S18_3136,22,100,100,2200,2200,0
2095121,11/13/2011,20111113,S18_1097,21,96.84,50,2037,1050,987
2173435,11/13/2011,20111113,S700_2824,23,86.99,10,2001,230,1771
2072080,11/13/2011,20111113,S10_1949,23,100,10,2300,230,2070
2077610,11/13/2011,20111113,S10_4962,28,100,25,2800,700,2100
2165788,11/13/2011,20111113,S32_3522,49,64.64,10,3185,490,2695
2083631,11/13/2011,20111113,S12_1666,41,100,25,4100,1025,3075
2223311,11/14/2011,20111114,S24_4048,49,100,315,4900,15435,-10535
2392990,11/14/2011,20111114,S24_3816,36,85.54,265,3096,9540,-6444
2294805,11/14/2011,20111114,S18_4522,47,77.24,200,3619,9400,-5781
2213367,11/14/2011,20111114,S24_1444,31,60.11,225,1860,6975,-5115
2387124,11/14/2011,20111114,S18_3856,46,100,150,4600,6900,-2300
2272727,11/14/2011,20111114,S18_4027,39,100,150,3900,5850,-1950
2261838,11/14/2011,20111114,S18_3259,49,80.67,100,3969,4900,-931
2207717,11/14/2011,20111114,S18_2432,44,60.16,70,2640,3080,-440
2384555,11/14/2011,20111114,S18_3029,32,89.46,90,2848,2880,-32
2211759,11/14/2011,20111114,S18_3232,28,100,100,2800,2800,0
2245632,11/14/2011,20111114,S18_3140,28,100,100,2800,2800,0
2306301,11/14/2011,20111114,S50_1514,20,48.62,10,980,200,780
2220541,11/14/2011,20111114,S24_2840,42,31.82,10,1344,420,924
2307655,11/14/2011,20111114,S700_1138,21,54,10,1134,210,924
2406656,11/14/2011,20111114,S72_1253,28,52.14,10,1456,280,1176
2391475,11/14/2011,20111114,S24_3420,21,69.04,10,1449,210,1239
2388597,11/14/2011,20111114,S24_2841,22,69.2,10,1518,220,1298
2368846,11/14/2011,20111114,S72_3212,28,64.43,10,1792,280,1512
2331070,11/14/2011,20111114,S700_3962,22,79.45,10,1738,220,1518
2242755,11/14/2011,20111114,S12_1108,21,100,25,2100,525,1575
2382546,11/14/2011,20111114,S18_1662,32,100,50,3200,1600,1600
2228187,11/14/2011,20111114,S32_2509,33,62.77,10,2079,330,1749
2198907,11/14/2011,20111114,S18_2319,46,100,60,4600,2760,1840
2320739,11/14/2011,20111114,S700_2610,39,57.82,10,2262,390,1872
2228619,11/14/2011,20111114,S32_3207,48,50.95,10,2448,480,1968
2243064,11/14/2011,20111114,S12_3148,33,100,40,3300,1320,1980
2372445,11/14/2011,20111114,S10_4757,26,100,20,2600,520,2080
2305407,11/14/2011,20111114,S24_3151,33,74.35,10,2442,330,2112
2217702,11/14/2011,20111114,S24_2300,24,100,10,2400,240,2160
2176556,11/14/2011,20111114,S12_4473,37,100,40,3700,1480,2220
2181021,11/14/2011,20111114,S18_2238,46,100,50,4600,2300,2300
2309245,11/14/2011,20111114,S700_1938,30,94.4,10,2820,300,2520
2245578,11/14/2011,20111114,S12_3891,43,100,40,4300,1720,2580
2298433,11/14/2011,20111114,S24_2011,30,100,10,3000,300,2700
2329098,11/14/2011,20111114,S700_3505,37,100,10,3700,370,3330
2232905,11/14/2011,20111114,S50_1392,45,100,10,4500,450,4050
2223642,11/14/2011,20111114,S32_1268,46,100,10,4600,460,4140
2422670,11/15/2011,20111115,S24_3949,43,58,415,2494,17845,-15351
2413741,11/15/2011,20111115,S24_1785,46,95.2,315,4370,14490,-10120
2409899,11/15/2011,20111115,S18_2581,45,93.77,75,4230,3375,855
2440652,11/15/2011,20111115,S50_1341,41,38.84,10,1599,410,1189
2423328,11/15/2011,20111115,S24_4278,33,59.41,15,1947,495,1452
2440205,11/15/2011,20111115,S32_4289,31,60.54,10,1891,310,1581
2451446,11/15/2011,20111115,S700_3167,34,88,10,2992,340,2652
2454935,11/15/2011,20111115,S700_4002,44,71.81,10,3168,440,2728
2441650,11/15/2011,20111115,S700_1691,34,92.25,10,3128,340,2788
2446893,11/15/2011,20111115,S700_2466,44,100,10,4400,440,3960
2499884,11/18/2011,20111118,S24_1578,25,100,240,2500,6000,-3500
2495151,11/18/2011,20111118,S18_2625,32,65.42,75,2080,2400,-320
2535155,11/18/2011,20111118,S12_2823,28,100,35,2800,980,1820
2526441,11/18/2011,20111118,S700_2834,29,100,10,2900,290,2610
2459553,11/18/2011,20111118,S10_2016,38,96.34,15,3648,570,3078
2503153,11/18/2011,20111118,S24_2000,40,91.4,10,3640,400,3240
2473728,11/18/2011,20111118,S10_4698,45,100,15,4500,675,3825
2523015,11/18/2011,20111118,S32_1374,44,98.89,10,4356,440,3916
2455332,11/18/2011,20111118,S10_1678,48,100,10,4800,480,4320
2543662,11/19/2011,20111119,S32_2206,46,32.99,10,1518,460,1058
2545084,11/19/2011,20111119,S50_4713,40,66.72,10,2680,400,2280
2538720,11/19/2011,20111119,S24_2360,42,76.19,10,3192,420,2772
2543821,11/19/2011,20111119,S32_4485,42,85.72,10,3612,420,3192
2746446,11/20/2011,20111120,S24_3856,45,100,365,4500,16425,-11925
2660833,11/20/2011,20111120,S24_1628,47,53.83,265,2538,12455,-9917
2655286,11/20/2011,20111120,S24_1046,37,69.82,215,2590,7955,-5365
2569306,11/20/2011,20111120,S18_4721,32,100,215,3200,6880,-3680
2566736,11/20/2011,20111120,S18_3782,43,72.74,125,3139,5375,-2236
2653857,11/20/2011,20111120,S18_3685,45,100,115,4500,5175,-675
2559426,11/20/2011,20111120,S18_3482,23,100,115,2300,2645,-345
2552577,11/20/2011,20111120,S18_3278,36,94.88,100,3420,3600,-180
2652492,11/20/2011,20111120,S18_3232,26,100,100,2600,2600,0
2724184,11/20/2011,20111120,S24_2972,30,30.59,10,930,300,630
2552500,11/20/2011,20111120,S12_3990,30,64.64,40,1950,1200,750
2651114,11/20/2011,20111120,S18_2870,38,100,75,3800,2850,950
2615813,11/20/2011,20111120,S18_1129,22,100,50,2200,1100,1100
2622832,11/20/2011,20111120,S18_1589,29,100,50,2900,1450,1450
2601158,11/20/2011,20111120,S12_4675,27,100,45,2700,1215,1485
2548018,11/20/2011,20111120,S12_1099,21,100,25,2100,525,1575
2636067,11/20/2011,20111120,S18_1889,45,90.86,50,4095,2250,1845
2725567,11/20/2011,20111120,S24_3191,32,72.77,10,2336,320,2016
2710614,11/20/2011,20111120,S24_2887,23,100,10,2300,230,2070
2637693,11/20/2011,20111120,S18_1984,47,100,50,4700,2350,2350
2549245,11/20/2011,20111120,S12_3380,40,100,40,4000,1600,2400
2573867,11/20/2011,20111120,S24_3371,48,60.01,10,2880,480,2400
2574054,11/20/2011,20111120,S24_4620,44,66.29,10,2904,440,2464
2688732,11/20/2011,20111120,S24_2766,46,83.6,10,3864,460,3404
2745111,11/20/2011,20111120,S24_3432,46,100,10,4600,460,4140
163496,11/21/2011,20111121,S24_1937,26,29.21,365,754,9490,-8736
176673,11/21/2011,20111121,S24_4258,20,100,365,2000,7300,-5300
171128,11/21/2011,20111121,S24_3969,22,41.03,265,902,5830,-4928
163496,11/21/2011,20111121,S18_4933,25,76.26,215,1900,5375,-3475
163496,11/21/2011,20111121,S18_4409,24,97.55,200,2352,4800,-2448
153355,11/21/2011,20111121,S18_2957,24,51.84,90,1248,2160,-912
163496,11/21/2011,20111121,S18_3320,32,79.37,100,2528,3200,-672
155815,11/21/2011,20111121,S18_3136,23,100,100,2300,2300,0
151054,11/21/2011,20111121,S18_2949,28,93.21,90,2604,2520,84
2748530,11/21/2011,20111121,S18_1367,46,53.37,50,2438,2300,138
2749869,11/21/2011,20111121,S18_2248,42,59.33,50,2478,2100,378
137435,11/21/2011,20111121,S18_2795,22,100,75,2200,1650,550
169882,11/21/2011,20111121,S24_2022,20,50.62,10,1020,200,820
2749516,11/21/2011,20111121,S18_1749,21,100,50,2100,1050,1050
2746907,11/21/2011,20111121,S18_1342,28,100,50,2800,1400,1400
137435,11/21/2011,20111121,S18_2325,44,100,60,4400,2640,1760
247949,11/25/2011,20111125,S24_4048,34,100,315,3400,10710,-7310
247949,11/25/2011,20111125,S24_1444,44,66.47,225,2904,9900,-6996
205771,11/25/2011,20111125,S18_4668,41,44.78,215,1845,8815,-6970
198731,11/25/2011,20111125,S18_4600,32,100,200,3200,6400,-3200
198076,11/25/2011,20111125,S18_2432,45,70.49,70,3150,3150,0
247949,11/25/2011,20111125,S18_3232,50,100,100,5000,5000,0
247949,11/25/2011,20111125,S24_2840,32,28.29,10,896,320,576
196646,11/25/2011,20111125,S18_1097,21,93.34,50,1953,1050,903
247949,11/25/2011,20111125,S32_2509,32,43.29,10,1376,320,1056
236745,11/25/2011,20111125,S18_2238,27,100,50,2700,1350,1350
244692,11/25/2011,20111125,S18_2319,35,100,60,3500,2100,1400
247949,11/25/2011,20111125,S32_3207,33,54.68,10,1815,330,1485
205771,11/25/2011,20111125,S32_3522,39,54.94,10,2145,390,1755
184419,11/25/2011,20111125,S10_4962,26,100,25,2600,650,1950
225635,11/25/2011,20111125,S700_2824,26,89.01,10,2314,260,2054
188678,11/25/2011,20111125,S12_1666,38,100,25,3800,950,2850
235603,11/25/2011,20111125,S12_4473,49,100,40,4900,1960,2940
205771,11/25/2011,20111125,S32_1268,37,97.27,10,3589,370,3219
183759,11/25/2011,20111125,S10_1949,42,100,10,4200,420,3780
205771,11/25/2011,20111125,S24_2300,49,100,10,4900,490,4410
247949,11/25/2011,20111125,S50_1392,49,100,10,4900,490,4410
378139,11/26/2011,20111126,S18_4522,50,100,200,5000,10000,-5000
382252,11/26/2011,20111126,S24_3816,22,86.38,265,1892,5830,-3938
345858,11/26/2011,20111126,S18_4027,27,100,150,2700,4050,-1350
373896,11/26/2011,20111126,S18_3856,22,100,150,2200,3300,-1100
348941,11/26/2011,20111126,S18_3029,46,87.74,90,4048,4140,-92
321991,11/26/2011,20111126,S18_3140,49,100,100,4900,4900,0
327918,11/26/2011,20111126,S18_3259,35,100,100,3500,3500,0
391055,11/26/2011,20111126,S72_1253,29,41.71,10,1218,290,928
391055,11/26/2011,20111126,S700_1138,23,64.67,10,1495,230,1265
317236,11/26/2011,20111126,S12_3148,24,100,40,2400,960,1440
421982,11/26/2011,20111126,S72_3212,42,50.23,10,2100,420,1680
391055,11/26/2011,20111126,S700_3505,27,92.16,10,2484,270,2214
320332,11/26/2011,20111126,S12_3891,38,100,40,3800,1520,2280
348941,11/26/2011,20111126,S50_1514,46,62.09,10,2852,460,2392
391055,11/26/2011,20111126,S700_3962,35,93.35,10,3255,350,2905
381710,11/26/2011,20111126,S24_3151,47,83.2,10,3901,470,3431
391055,11/26/2011,20111126,S700_2610,50,78.79,10,3950,500,3450
308586,11/26/2011,20111126,S12_1108,47,100,25,4700,1175,3525
348941,11/26/2011,20111126,S10_4757,45,100,20,4500,900,3600
380772,11/26/2011,20111126,S24_2011,41,100,10,4100,410,3690
348941,11/26/2011,20111126,S700_1938,50,94.4,10,4700,500,4200
437757,11/27/2011,20111127,S24_3949,43,66.19,415,2838,17845,-15007
436345,11/27/2011,20111127,S24_3420,27,71.67,10,1944,270,1674
426421,11/27/2011,20111127,S18_1662,42,100,50,4200,2100,2100
437757,11/27/2011,20111127,S700_4002,40,63.67,10,2560,400,2160
431566,11/27/2011,20111127,S24_2841,48,67.82,10,3264,480,2784
437757,11/27/2011,20111127,S700_2466,42,100,10,4200,420,3780
475606,12/1/2011,20111201,S24_1785,33,98.48,315,3234,10395,-7161
517164,12/1/2011,20111201,S24_1578,39,100,240,3900,9360,-5460
517164,12/1/2011,20111201,S18_2625,30,64.81,75,1950,2250,-300
458081,12/1/2011,20111201,S18_2581,28,92.93,75,2604,2100,504
437757,12/1/2011,20111201,S50_1341,29,38.4,10,1102,290,812
483898,12/1/2011,20111201,S32_4289,27,67.41,10,1809,270,1539
517164,12/1/2011,20111201,S24_2000,25,73.88,10,1850,250,1600
516254,12/1/2011,20111201,S12_2823,25,100,35,2500,875,1625
489689,12/1/2011,20111201,S10_1678,22,98.57,10,2178,220,1958
490265,12/1/2011,20111201,S10_2016,24,100,15,2400,360,2040
480861,12/1/2011,20111201,S24_4278,39,72.45,15,2808,585,2223
454169,12/1/2011,20111201,S700_3167,38,82.4,10,3116,380,2736
483496,12/1/2011,20111201,S32_1374,35,100,10,3500,350,3150
437757,12/1/2011,20111201,S700_1691,48,83.12,10,3984,480,3504
486738,12/1/2011,20111201,S700_2834,39,100,10,3900,390,3510
507420,12/1/2011,20111201,S10_4698,49,100,15,4900,735,4165
592732,12/2/2011,20111202,S24_3856,47,100,365,4700,17155,-12455
652111,12/2/2011,20111202,S24_1628,45,49.81,265,2250,11925,-9675
665357,12/2/2011,20111202,S24_3969,39,33.23,265,1287,10335,-9048
636158,12/2/2011,20111202,S18_4933,45,76.26,215,3420,9675,-6255
529127,12/2/2011,20111202,S18_4721,43,100,215,4300,9245,-4945
626710,12/2/2011,20111202,S18_4409,29,85.59,200,2494,5800,-3306
651411,12/2/2011,20111202,S24_1046,20,62.47,215,1240,4300,-3060
517164,12/2/2011,20111202,S18_3782,30,54.71,125,1650,3750,-2100
624153,12/2/2011,20111202,S18_3685,35,100,115,3500,4025,-525
564993,12/2/2011,20111202,S18_3482,32,100,115,3200,3680,-480
563249,12/2/2011,20111202,S18_3278,33,86.04,100,2838,3300,-462
551672,12/2/2011,20111202,S18_3232,48,100,100,4800,4800,0
614475,12/2/2011,20111202,S18_2248,23,71.44,50,1633,1150,483
566908,12/2/2011,20111202,S24_2972,21,37,10,777,210,567
620576,12/2/2011,20111202,S18_2870,27,100,75,2700,2025,675
534647,12/2/2011,20111202,S32_2206,27,44.25,10,1188,270,918
616491,12/2/2011,20111202,S18_2325,26,100,60,2600,1560,1040
543009,12/2/2011,20111202,S12_3380,20,100,40,2000,800,1200
540832,12/2/2011,20111202,S12_1099,20,100,25,2000,500,1500
549100,12/2/2011,20111202,S18_1889,45,85.47,50,3825,2250,1575
608219,12/2/2011,20111202,S18_1749,33,100,50,3300,1650,1650
578998,12/2/2011,20111202,S24_3371,34,64.9,10,2210,340,1870
543201,12/2/2011,20111202,S12_3990,44,82.99,40,3652,1760,1892
613368,12/2/2011,20111202,S18_1984,38,100,50,3800,1900,1900
601230,12/2/2011,20111202,S18_1589,40,100,50,4000,2000,2000
594860,12/2/2011,20111202,S18_1129,42,100,50,4200,2100,2100
548157,12/2/2011,20111202,S12_4675,47,100,45,4700,2115,2585
537814,12/2/2011,20111202,S32_4485,31,100,10,3100,310,2790
654337,12/2/2011,20111202,S24_3191,40,79.62,10,3200,400,2800
530995,12/2/2011,20111202,S24_2360,50,69.26,10,3450,500,2950
540787,12/2/2011,20111202,S50_4713,40,89.5,10,3600,400,3200
652865,12/2/2011,20111202,S24_2887,42,100,10,4200,420,3780
532517,12/2/2011,20111202,S24_4620,50,87.31,10,4350,500,3850
664679,12/2/2011,20111202,S24_3432,48,91.02,10,4368,480,3888
652746,12/2/2011,20111202,S24_2766,47,96.32,10,4512,470,4042
697281,12/3/2011,20111203,S24_1937,32,37.17,365,1184,11680,-10496
689530,12/3/2011,20111203,S18_1367,48,63.61,50,3072,2400,672
697671,12/3/2011,20111203,S24_2022,24,38.08,10,912,240,672
691290,12/3/2011,20111203,S18_2795,40,100,75,4000,3000,1000
671965,12/3/2011,20111203,S18_1342,36,100,50,3600,1800,1800
